(79, 20)
NBNNNHNNNHHNNNHBNHHHNNHBHNNNBBHTNBNNNHHNNHTNNTHHNNNTHTNNHNNBHNNNNNTNHNHNHBNHBNHTNTTNNTNBNNNNHNNNTHBN
HBNBNNBTTBHHTTHTNBHNTNNNNHBBNHTTHHTNTHNTBHNNTHNNTNNNTNTHTHNNNHNNNNNHNBBNNNNNNHTTNNNNBTTTNHBTNBNNHNHH
NNNNTNHNHNNNBHTBTNTTNBTNHHHNNNNBNTNTNTNBNNBNHTNNNNNTNNNBHNBHNHTBHHTNTNNNHTTHNHHTNNNTBTTBTHNTNHHNTTTN
NNTTNBHTNHNNNHNNNNTHNNHHNNBTNHNNTNNNNTHHNNNNNTHNNHNHNHNTNNTNTNNHTNNNBHNNTNHTNTNTNNNNHNHBNHNNTTHNNBNN
NNNTNNNBNNBTTTNNBHNTNHHTHNNNTTHTHNNNNBNHNHHHNNHHHNNNBTHNNHNNHHNHTNHBNHNHNNNTHTNTNHHHNNNNNNNNNHHNBTTN
NNHBBBNTNNNTTNNHNTTHNHNTNNTNTNTBTTNBNNNNBBNTBBNTNNTNNNBNNBNNTBNNNTHNHNBNHNHNHBBBBTHHBBNBNBNHNTTTNBHN
HBNNHNNTNNHNNBNTNNNHNBNHNHNBNBNHNHNNNNHTTBNNNNNBNNNBHNNTHNNNTTNNHTHBTBBNNHBTHHNNNHNTNBNNNTNHHNTNNTTN
HTHNBNTHHHNNNHHTBNNHTNTTNHHHNNBNNNTNTHNHBNTBNNNNBHNTNNTHNBNNNTTTNHTNBNNNHNHNHNNNNBBNNNNNNNNNHHNNBNNN
NNNNBHTNHNTHTNBNTNNNHTHHHNNNHTNTTHNNHBNTTHTNNNHNTBTTHNHHNNHHBTHHTBHHNBNNHTHHNNTNNHTNHHNNNTNTTBNTNBNT
NHTNTHHTNNHNHHNNHTNNNHTHTHNNTNNHNBNTNTNBTNNNHNTTTHHNTHTBBNTNHNNNNBBNHNNTNHBHNTTHNTNNNBNTNNNHNTNHNBHN
NNNNHHTHHHTNNNNNNBBHHNNTTNNHBTHNNHHTHNNBHBNBHNNNHNNBHBTNTTNTNTNTNNNBBNBNNTNNBNNTHNNNNNNNNBHNNNBNNHHT
NHNNNBNHTNNNNNNNNHBHNNBBTHTNBNNNTHHNTNNNTTHHHNHNTHNNNNHBBNNNBNNTHBTTNHNHTTHTNBHNHHHNTNNNTNTNTTTNHHTN
NBTNNTHNHTNTTNHBBNNNHNNHNHNNNTNNNNTHHHNBNTTNTHNHHTTNTNNBHNTHTNHNTNNBNTNHNHTBNBTNNNHHNTHHHHNHTTNTBTTH
NTHNNNNTNHHNNTHTBHHTTNNHNHHHHNNNNBNTNTNNBNHNBHHTNHBNNBHNNBTNNTHBTNTHNHHNNNTNHNNHNNNNBHTHNBNNNTBNBHNT
NNTNTBBNTNHBBNBNNTHNTTNTHNNNNHNNHTNNNNNNTNTTTNNNNNTNNTTHHHNHNTNBHNNNNTNNNNNNTNNNNHHNNNNTTNHTHNBBBTNT
THNTTNNNHHNNTTTTNHBNNNNBTNBNHNNHHHHNTNNTNNNTHHNBNBBHHNTHNNHNBBNTHNNNNNNNNNNBHHTNTHTNNNNBTNTNNBNNNNNT
BNHTNHNHNNNNNTTNTBNNHNNTTHTBHBTBNHHNNNHNNHTNHTNNNNBTTHNNNTBBNTNNHTNTNTNHTHNNNNHTNHTNBTNTNNTNHNNNBNHB
NBNTNNNTBNBTHBNNNHTNTHNBNNTNHNNHNHNNTNTBNNHNTNHNTNNNTNNNNHTNNNBNBNHHNHNNTBTTNNNNBTNNHBHNTNNTTNNTNNTT
THHTBTHNTTTTNTTNHTNTTTNNHTTNTNHHNNHTNNNNHNNNBNNNHHTBNHTNNNTTHNNHNTBHNHNNBHBBHNNHNTTNNBNNTNNNNTTHBNTB
NNNNTNNNNNNNNNNNBNHNHHBHTNTHTNHNNNHTBNNBTHNNTTNNHBTNTNNNNNTNNNNBTHTNNHNNTTHNTTTNNNNNHNTTNNHTBHTNBNNH
TNTNNBNNTBNTBNNNNNNNNBHNHBTTNHNNNHNTNTNNNHTNHNHTBTNNNTNTTTTNHNNNNBHNBHNTNNNNNTHNHTHHNHBNBNNNHNNTNNNB
HNNHHNNNBNHHHNNNNTNNNTBNNNNNNHBHHNHBNNNHTNHNHNNNTNNNTHNNBBHHHNNNTNNTHNHNNHNNTHHNNNNHNHNTHTHNBNNBTNNT
NTNHTBNHNTTTTNHHNHTNHNNTHNHTBHTNNTHHNNHBNNNHHTBHNNNBTNHTBNHTNTTHNHNNTNTHTNNNNBHNBTNBBNNTNNNNNTTNNHTH
TNHNNNTHNNNNNHTHHNTNTNBHNNTNBNNTTNHHNTNHNHNTBNHNHHNNBTTTNNNNTHHNNNNNTNNNNBTNBNNTNHHNNNNNNNNNNBNTNHNH
NNNNHNNHTNNNTHHNBTHHNNNBNTNBTNHTHTTTBBTNNTNHNNHNNTNHHTTTNTTTTNNNNNNNBHTNHNTHHNTBHHBNNNBTHHHNNNTHNTHN
NNBTTNHNNTHNTNNNHNHNTHNTHTTNBNTHHNNHBNHBBNHNTBTNNBNNNNNNNNNHHNNNNNTTNNNHNTHHTNHNNBNNHNHBNNNBTNNNNNNH
NHNHNNNHBNHHTNTNHNHBNNNNNNNTTBNNNHNTNNTNNNTHTNTBNNHTNHNNNBNNNNTTNBNNNHNBNNTTTNNTTNNTNHNNBNNHTTTTNNNN
NTHHTHNHTBHHHBHBNHNHNNTTTNNTHBTNNTTNTHNHHNNTNNHBTTTBHNNNBHHNNTHNNTNBHNNNHHNNBHTNBTTNTNNBTTNBTNNHBNNT
HHTHHNNNNHTHHTTBTHNHTHTHNNNBBNBNNBNHNTNHNHTTTNNTNNBHNBNHTNTBTTNNNBNTNBNHNHBNTTNNHNNNNNTNNNNNTHNNTNNN
TNNNNNNBNTNTNTNNNTTHNNNTNHNNTHHNNBBTNTNBHTNNTBBTNTBNNNHBNNHTNNNHNBHNHNHTTHNTBTNNNNHNTNNHNTNNTNNHNTNH
NBNTTNBNNNTTNNTNHNNNTNNNBNNHTTBHBNHNHNBNHNTBNNNNNNNHNBTNTNNBTNTNNNNNBNTNNNNBHTNNNBHHTNTTNHHNNNNHNNNN
NNTNHNHTNHTNNNNBHHNNBNNHHBNTNBNBNHNNHHNNHTTBBNTNNBHTTHNBHHTBHBHHBBBHTHBNHNNHHNTNTNNHHNTBBHNNTNNNTNBB
NTHBNTHNNTTNNNNNNHNNTBNNNNBNNHNNBNBNNNBHHNNNHNHTTNNNNNNNNHTTNNTHNNNNTNNHTHBNNTNNNBBNTNNNBNNHTHHNBBNN
TNTTNBNNNNNNNNNNBNNNNNBNNNNNNTBNHNNNHNTNNNNNHTTHHNNNTNTTNNHTNNTNNHNTNNBTTTBNNTNTNHBTTTNHTNNNNNTHBTNN
NNNNNTNNTNHHTNBBNBNNTTTBNHHNBTHNNHTBNNNHNHNTTTNHNHNNTHNNBTBTHTHNNNNHNHHNTNTNHTTNNNTTTBNTNHHNNBTNNNNT
HTNTNTHNNTTHNNNNNNHNHNHTTNTNNNTNHHHHNHBNNTHHTNNHHHNTHTNHTHNNNNHHBTHBHNTNNTNHNNHNNHTNTBBNNTNBNHHNBNTN
NHNNHTHNNBTNNTNTNTHHHTHNNNNTNNNNNNNHNNBBNHNNTNTNHHHNBTNNNNNNBNTNNNNBTBNNNTTNBHHNNHTHNNHNNBBHTNNNTNHT
THNTNNNNNHBBTTTNNHNNNHNBTTHNNNHNHTHNNHHNBBHNNNHBNHTNTTNNTBHTBNHHNTNNNHNNNNHNHHTBNTNNNNTHHNTNNBNBNNNN
HHNHHTTNNBTBHNTNHTTBNBNNBHHNBNBNNHBNHHNBNBNNNNNTNHNNNTNHNNTTTNHNHTHNTBHTBNTHNTNNTNNNTNTNTTNTHNNTNTTN
NNTHNTNTNTHNHHHNNHHNNNNTBNBHTNHNHNNNNHNHHNNBNNNTNTBHNNNNHTHNTNBTHBNNBBNHHHTNHHNTNNNTTHBNNTNTNTNHNBNN
NNHNNTHNNHTNNNNNNTHNNNHTNNHTNNBTNHHNHNNNBBNNTHHHNNTNTHNNHNNTNNHNNTHNHNNTNTNBHNNNNHTHHNNTTTNHNNNTNTNN
THBHNBHNTHNBNNTTNTNTTTHTNNTTHNHBNBTTTNHNTNHNHNNNNNNTNNHNTNHNNNNBHNNNBTBNNHNNBBNHBBHTHNNNNNHHBNHTNTTN
NHHNHNBBNBNNHHTBNNNNNBHTNHNNHHTBNTNBHTNNNNNTNTBTNTHTNTHNNBTTNNBNHBTHHNHNNHHTNNHNHNNTNTNHHNBNNNHTTHBH
THHNTHNNBBHNTBHHHNTBHHNHHHNNBTTHTNNNTNBNHNNTBHNHTNBBNHNNTBNTNTNTNNHNBNTHHNNNBNHNNNNNNNNNTNTNNTNTNHHN
TTHNNHTNNTTNBNBHTTNNTTNHBHNNNHNTNTNNHNNNHBNNNHHBNTTNTHNBNHTBTTTNHNNHNNNNNNNNTNNNNTNTNNHNNBHNHNHNNHNN
TTTHNHNTTNNNHTBTNHNTNNHNNHNNNNHNNHTNNNBBHNNNNNBNNTTTHNNNNHNTNHNNHNNNNHTHHTTTNBHTNNTNHNNHNHNHNTHNNNHT
NTNTNHNBNHHNNNNBBTNNTTHTBTNHHHNNBHTNNBNNNNNNNTNTNHNNNTTHNTBNBNTTHNBNTTTHNNTBNNNNNHNTTNTNTTNTNNNTBNNN
HNHNTTHNTTNNTTNBNNNHHBNNNHHHHNNBBTNNHNNTBTNTNHBTTTTTNNNBNNBNTBHNNTBBNNNNNTTTNNNNNNNTNHHNNNNNHTNNNTTH
BNNHNNNHTNNNNNTBTNNNNHTNNNTNHNBTTNHNBNNBHNNHBNNHHTNTTNBNNTNNHNNBHNTNBNHNHHNNNNNHTHTNNNTNNNNTNTHTNNTN
BNBNNHNTNNTTTTNHHNNHNHNTNBNHNNHHNTNBNNTTNHHNHNNNNNNTTHNNNNNNNBTNNNHNHNTNTHBTNNNNNTTBNTNTNNNNNNNHHNNN
HTNNNTTNNNTNNHNNNTHHTNNNNHTNHHNNNTNNNHNNNHHHNNTNHNNNTBNHTBTNNTNNNNTTNTTNNHNHNHNBNNNHNNNTBNTHHBNTNTNN
TNHTNNNTNNTTTNNBNNTTTNNNBNNHHTNNTHTNNHNHHHNTNHNNNHNHNHNNTTHNHNNNHNNHNBBBTTNBNNHHNNBNNNHNNBNHNTBTHNTH
BNTNNNNNNTTTHBBNNBNNNHNNBHHNHNTTNNTNNBNNHNNTHNBTTHTHHNNNNHNNNHHHNTBHNNNTHNTTNNNHHNHNNHNHHNNNNBTNNTHN
NHNBHHTNBNNNBNTBBHNNNNTNHTBTHBNTNNTHNHNNNNHNNTTNTHNNNTNTTHHNNNTTNTNTBNNBNHNNHNBHNNHHNTTTNNNNNBNNNNHN
HNTNNNBHNBNBNNHNTBNTHNBTNNBTHHTTTTBNNNHTHHNNBNNHNNNTNHHTBTNTNNTHHTBHTNNNBHHHBNNNNNHTNHTNBTBNNNNNNNNN
NNNNHNHBBTTNTNNNNHNHBHTHHTHHBHNHHHHNBHNHNHHNNNHHTBTNTNBTNHHHNNHBNHBTNNNBNNHNTNNTNNTNTNHTHHNNNBNBBBTN
TNNHHNNHTNHTNNHTNNHBTTTNNNNBNTNBTTNHNNTNHHNTNBHTHTNTBHNNNBHBTHNTNTNHTNTBHTHNNBTNNTHTHBNBHBNNNBTNHTNH
TNTNNNNNHNNNTNTTTNBNHNNNNTTHNHHHNNNHNHHTHNNTHTBNHNHTNTTBTNNNBTHNTBNNTNNTNNHNNNTTNNHBNNTTNBNNBTHHBTNN
TNNTNTNTNHNBNHNNTNHHNHTNHNNHHNNNNNNNNNNNHTBHNNNTTTNNHHNNTTNNNNHNTTNTNNNNNTNNNNHHTTNNNNTNBBTNNTNNTNTH
NNNNBHNTNTNNNHNNTNTHNHTNTTNHBNNNNBNNNNNNNNNTHNNNBHHNNBTNNTTNTTTNNNTNNBHBNBHNTNBNBNNTTBHNHNTNNNNNNNTH
NNTNHNTNTBNNHNNBNHNHNNNNNNNTNNHNNBHNTNHTBHNTHNNHHNTNNTNNNNNTNHTTHNNTBNNTNNNNBTTTNBNTTTTNNNHNNNBNTNNB
TNTTHNNNNNBBHTHNTHHNNTHNNBHNBTHNNTNNNNBHNNNHTBNBNNTNBBNNTNNTHNTNNNNTNNTHHNNNTNHNNNTNNNNNHTTHNNNNNHNN
HNBHNHTBNNNNTHTNTNNTNNHHNNNNTNHNHBTTTNHNNTHTHNNNHNTNNHHBNNNNNNHNTHNHNNHBTTTNNNTBNNNTTHNHHNNTNTTNNNNH
HHTNNNNHBNNNNHBHNTNTHHNNNNNNNNHNNNNHHNNTHNNNTNNHTNNHHHNTNBNHNNHBBHNNNNNTHHBBNNNBTTNNNTNHTHNHBBTNHTNH
HHNNHTTNNNNHHHHNHNHTHTNHNNNBHNHHHNTNHNHNTNNNNNNHNHTNNNNHHTNHHNHNNNNTHTHNNNNNNBNHBNHNHHNNTNHHNNNTTNNN
NHTHNTNNTHBTNNTBHNTNNNNNTBHHBTBHNNHNHNHNNTTNTNNHTNNNNTBNNNNBNTNTNNNTHHNNBNBNNTNNNTNBNNHHNNHNNNTHNTHB
HHNNNNNTNNNTNBBTBNHHTNHNTTNTHTHHNNNNNNNTNNNTNHHNNTTNBHNNHNTBNNNTNBTBHNTBNHNNNNNNHHBNHNNHNNHHNNNHBHTN
NTNTTTBNBNNHNTNHHTBTNTNNHNNNNBNNNTBNNNNBBNNNTNNNNHNTNNHTNHNNBTNHNNNNNNNHNBNNNTHNNNBNNNTTTNNNNNTTNNBN
NNNNTNNNHHHNNNNTNHTNNHTNHNNBNTNTHHNNNHNTNHHTNNHNNNTNTNNNNTHTNNNNTHBNNNNHTTNBHHHNHHNNNTHTNNTHHTBNNNHN
NBTNNNTNHNNNHNNNNHBNBTNNTHNNNBNTNNTNNNTNNBNHNHNNTNTNBNTBHNTHNNNHNNNNHTNNHNNTNHNTNNNHHBNHTNTNNHNBNHHN
BNTTTNTNTNNTNTNHNHNHNHTNBNNNNBNHTNBTNNBNNTNNNNTNNBNNNTHTTNHNHHNTNNHHNNNHTBHNTHNNTTNBNTNTNNTNNTNHTHTN
BHBNHHNBHNTBHNNNNHHNTHNHBNHTNNNBNTNNNNTHNNNBHNTNNNTNNHTNNNNTNNNNTNHNNNNNHNNNHNTTNNNNNNNBHNNNNNNNNNTN
HNTTHHNNNHHNNNTTTNBNTTNBTHNNNTHHHBTBNNNNHNTNNTNNTHTTNTTTBNTTNNTHNTTNNHNNTNNNNNHTNNHHNNHNTNNBHNNBHBNH
NHHNNNNTNTBNHBBHHNNNHNNNNHNBNHTTHNNNNTTBTNNNHNNBNNHNHTNNNNTNNBNNTNHTTTNTNHNHHTBTNNNNNNTTNHNNNHTNHTNH
HNHTHHNNBTHBNNHHNHTNBNNNNTTNTNNTNNHHTTNNNNHNHHNTBTTNHNHNBBNNBNTNHNNNNNNHHBNTNNNTTTNTNNTNTNNHNNNNTNNH
BNNHNNNTHNNTNHTNHNHHNTNTNNNNHNNHBNNTNHHBHNTHNNTNHNHBNBHTNNHNNNNNNBNTBNTNTBNTHNTHTNNNNTTNHBBNBNNNNNNN
HNTNBNHNNNNTNNHTBHNNNNNBNNBHHNBNNBTHNTHNNTNNHNNHHNNNTTHTNNTNHHHNNTNNTTBNHNNNHNBNNHHNHNBTHTTHTBNBNTHN
NNHHNNBHNHNNNHTTHNHNNHNNHNHHHNTNNHNNHHNHNNTHHNBNNTHBTNNBTTBNNNBHNHNTNHTNHHNNHBNTTNHNTTNBNNNTBNNTNNNT
BNHNTHNNNTNTNTHNNTTHNNNBTBHNHHNNNHTNHNTNTBNHHHBNTNTTHTHNNHBNNNNTNNTNNNNHNNNNHBBHHNHNHTHNNHBNNNBNTHHN
TNTNNNNTTTNNNTHBNTNNTTTBNNNNHTBNNNHTHHHNTTBTNHTHNNHNHHNBTTTNTNNNNHNTHHNTHNNNNNNNNNTNNNBTNHNNTNNTNTHH
NTNNHNHTHNHNTTNHNNNNNNNNNHBNHTTBTNHBTTNTNNNHTNNNTNNNNTTNBHHNNNNBHNNHNBNNTHTNBNHNNHHNBBHNNTHHNTBNHHNH
NHNNHNTTTHTNNTBHTTTNTHTNNBNHNNTNNHTBNHTNTNBBNNNNBNNHNHTNBBBNTHNHNNHNHHNBNNNNHNNNHNNNHTNNNBTHHNNNTTNB
HNHHNNNNHNNHHHHBNNNTTNBNHBNHNNNHNNTNHBNHNNNHNNNTNNHHHNHNTNHHHNTNNTTHNNNTNTNBHHHHTBHNNNNNHTTNTTHNNNHB
NNNNTNNNNNNNNTHNNBTNNTTNNNHNBHHNNHHNTNBTHHNNNTNTNTNNNHNHNHHHNHHNHNNNHNTNNBBNNNNTNBHTNNHHTNNNNNTNNTBN
BNNTNTNBNNNNHHNNTHTBNHHTHNTTBHNHBNHHTNTNNHBNNNHTHNBHBHNNHNTTNNBTNNNNNBTHTNNTTHNTNNTHTTBTHNBNBHNNNHHN
HTNNNTNNNNBNHNHBBNTTTNNNTHHNNHTNHNBNNNHBHHNBNHTTHNNNHBTHNNNNBNNNHHTNNNNNHTBNHNHNNHNBHHHNHNNTTNNNNTTN
HNNTNTNTBNBHNBBBTTHHNHNNHHNNHTNNNTHTHHHTNNNTBTHBNNNTHNNNHHHNHBTNNNNBHTHNNNTTBHNTTNHHTNHNHTTHNNNNTNBT
TNNNNBBNNNNNBNHBNNHNHNBTTHNHBNHTTHNBNNTTNNNTTNNTTNNNNHNNNNNNNNNTTNTNBHTNTNHBNTNNTNBNHBHHNHBBHNNHBHTN
HHTHNNTHNTBTNNTHNHBHHNBTNNBBHNNTHNHTBBNHHNNNNTHNNNBHNBNBNTNTBBNTNNNNNBNHNNNNNNBNNHNNNBNNTNHNTTTNTHTB
NTNNNHHBHBTTNNTNHTHHBNHNNTBNHNTNBBTNTNNTNNNNNNHNNTTTNNNNNTBNNHHNNNBHTBNNNHNNHNNBBNTHNBTNNBHBNNHTNTNN
NBBHTNNNNTNNTHTNNNBNTNNNNTHNBNHHHBTHNTNHNHBNNNBHNNNHTHHNHNHHBNBNHNNTTNTBNNNNHNNHNNNNNNNNNHTTNNNTBTHN
NNNHNNNHNNTTNTTNNNTNNNNBNHNNNHNBHTBHHNNNTNHNNNNNNHTNHNBHTHNBNNNBBNNNNHNNNNTNTHTTNNNHBTNHTHNNNNTHNNTN
NNNNNHTHNNNBBBNTHTNNHHHNHTBTNNTBBNNNTBTNHNNHNTNHNHNNHTTNNBNNNHNNTTNNHNNHNBBNHNNHTNTTNNHNBTTHHBNNBHHT
TNTHHNNTNBNBHNBHNHNHTNTHNBTNTTNHNNNNNHBNNBNNTNBNTNHTNBNHNNTTTHNNHTTNTNTNBNHNNNNNNNHNNNHHNHTTTHNBNNNT
NTNNTNBNNNHTBTBTHTNNNNNNNTHNNHNHBTNNNNNNNNNBNHNNHNTNNTNNHTTHHNHHNNBHTNHNHHNTNNTNNBNTBBTHTTNNTNNNNNNT
NTNNNNTHNHNNNBTNNNBBNNNNNTTTNNHTHTNTNHTNBNTNNTNNHNHNNNHTNNNNNHNNNNNHNNNHNBNNHNHNNTHNNTTNNBNNTNHHTNTT
BNTTNNTTTNTNNNHNNNNNBNHHHHTTBNNNTHHBNNHNBNNNHTTNTHNTNNBTNNNBTHTTNNNHNNNTNNNNBHBTNHNTTHNHTNNTHTNTNHBN
BNTNHBNBHNNNTNNNTHNHNNTNNNNHNNHTNNNTBNNHNBTHNBHNNNTNNBNNNTHBNTNHHNNTNNTBNBTNTBHTNNNTTNNTNNNHNNNTTTNN
NNBNTNNTTNTNNNHNTNNBNNHHNNNNNNBBTNHNNHNTNTNTBTBNNNTTTNNBNNTTNHNNTNNTNNNNNTHNHNNNTHTTNNNTNTTHNTNTTHNH
NNBTNTNBHHNNNNNTNNNTNTTNHBBBNNNNBNNNNNHHBNNNNNHNHHTHNNNTTHHBNBNNNHNNNNBTHHTNHTNNNBNHBBBTNBNTTBNNHTNN
