(75, 10)
NNNNNTNBTTNHNNBHNHTHHNNTNBHHTNNNHNTHTBTNNNNNNNNNHTNHNNTHNNHNNNNTNNNNTTHHTNNBNTBHNHBHHNNNNHNTBNHTNTTH
HNNNTNHHNNNTNBNNHNTTHTNNNNNNNNHHNTNHNBBHNNNNBNNNBNNHBNHTNTNNNNTNNHHNNNNBTNNTHNBTHNNNNNBNNNNNNNTBHHHH
NNBHNNNNBNNHHNNNTNNBNTTNNNTNNNTBNTBBTHNTTTTHNHNNNNHNNNHHNNBTHNHBNNNHNNNHNNNNHNHNNNNHBNBNBHNHHNNTNTNB
NHHNTHHHHNBBBNNNBTNTHNHNHNNTNNBHTNNNHNHNHNHHHNHTNNNBNNHNTTNNTHNBNBHNNTNHNNNTNHNTBTHNNNNNHHNNNNNNTTNN
HNNNNHNNHNNTNTBTNHTTTTHHTNBBTHHNHNHNHBNNNBTBNTTTNTHNNBNNHBNNNNNHNHNNNTNTNNTHNHHNNHNHHNBHHBTNHNNNNNHT
NTNBBNNNHNNNNHNNNNNTNNBHBBBNHNHHNBNNNNTNTNNNTNNHTBNNHNTNTTTNTTNHNNNNNHTNNTHTNNNNNNTNHBTBHTTNTNBTNNTN
NNTNNBNNNNNHHTNNTHTHTBBNHNNHBTBNBTNNBBTHNNNTTHNNNTNNBTNNHBHHTTNBNTTNNHTNTHHNTNTHNHTNNNNNNTNTNHNNHHHN
NNHHNHHNHNNHHHHTNNBTTHNTTBNNNNNNNBHNTNNNNNHNTBTNHTTTTNNTBNNTNNNBHHHTNNNTNNTNNNNBHNNHHNTHNNNTNTHNHNNB
HNTNBHNHBTHTTHTHHTNBNTNTNHNNTNTNNHNTNNNNHTNTTNHHHHNBNTHTTHHNHTTNBHNNNNNBNNNNTNBBNNNNNTNNBNHTNNTNNNHH
BNHNNTNTTNTNTHBTHHHNTNNNHNNNHHHNHBNNHTNHTBTNHNNNNBBNTNNBNNHTBHTNTNHHNHTNTBNTNHNTNNNNHHNTNHTTBNNNNNTH
NNTNNNNHNTNNNNNNTNNTTNNNNTNHNNNHHNNTHBTNNHHNHHHNTNNNNNTNHNNHHHTBNNNHNBNNTHBNBNBBBNNBNBHBTNTTTHBNTHHN
HHNHNTNNNNNNNBNTNNHNNNTHNNTBBNNNBNNNNNHNNHBNTNTTNBNHNNHNNNNNHBBBHTHNNBHNNHHTHNHTHNBHHTHBNTNTNBTNTTHT
NHNNNBTTNHHNNNNNTHHTNHHHNTTHHHHTNNNNNNHHTNBNNHHHNNHTNTHTNBTTNTHNNTTTNTNHNNNTNNHHTNHHNTNNNTNTHNNNHNTT
TNNHNHHTTTHNNTBNNNTHTHNTNHTNNNTHHNNNNTNNNHHHNNNTBNHTNNHHNHHHNBNTNHTNNHTBBNNNHNTNTNNHTNHTHNTHHNTNHBHH
NTHNTTHNBNNNTTNNTTHHNNHBTHHTBNBBNTTTNNTNTNTNNNNNNBNHTHHNNTNNTHTHNTNHNNNNTNNNNNNNHBHBNHBHHNNNTNTNTTNH
NNNTNHNBNNNBTTNTNTNNNTNHHNTTNHHNNBNHNNNNTTNTTNTBBNNHHHNNTHNNNBBNBHNNNNTNNNTTHNNNBBNTNNNTTHHNNHNHBBTB
TNTTNNHNNHNNNNNNHBNNTHNTNTTNNNHHNNNBNHNBHTNBNBHTNHNHNNHHTBHBNHNHNNNTNNNHHNNNTNHHNNNNHNNHNBBTNBTBNBNH
NTNNTNNNNNBTNHNNNHNNTTNNNNTNNTTNNNNHNBNNHHNNBNTTHTNHNTNNTNHTNHNNTBBNBHNBNBNNNHNNNTHBHNNNHNNTNTTNNNHH
NTHHBHNNNHNNBNHBNHNNNTTBNHNTNNTHTNNNHNBNHTNHNHBNBHNHHNTHNNTNNHTNNNBNHTHNBTNNNNNNNTTTNNNBNNNTHTBTNTBH
NNHBHNNHNHHHHNNHNNTNNTTNNNNHNTNHHHHNTTHNTNNTNTTNNNNTNTBNTTHHHNHNBNHNNNTNTNNBNNNHNNBNNTNTHBNNNNTNBHNN
NNHTNNNNNNTTBNNBHTNHTNNNNTNTTNNHNNNBNTNNNNHNNNTNNNNHTNNTTNNNNHBNTNHNHNNHNTNNNNBNTBTTNNHHNNNHNTTNNNNT
TNNNHHHNNNHTNNTHTNBBNNTNBNHHNNNHNNTNHNHNNNNNNBBHBBTNTNTNTHNNNTNHNNNNNNHBTNTNTNBBNNTNHBTTNNNNNNTNNHNT
NNNTNNHNHNNTNNHNNNNTNTTHHNNNTHNNHNNNBNNBNTHTNNTNBHNNNHNHNNNHNHTBNBNBNTHHNTHHTNNTNBTNNNNHTNTNNNHNTTHN
HTNNTNBNHNNHHTNNTHHHNNNBHTNTNNHHNNTTNNNHNNNNNNHTHNNNHNHHNBBNHHBNNTNBNNNNTNNNHTBBNHTTNTHBHNTTNHTNNHNN
NNNNTTNHNNTTBNNBTNNHNTHTNTNNHHHNNNNTNBNHNHNNNHNNBBNHHNNNBNBTTNTTNNNHHNNNNHTTTTHHNHHBNNNNHNNTHTNTNTBN
TTTHHHNNNBNNTTNTTNHNNNNNNTTBNBNTNBNNHNTNTHTNBNTBNHHNNBNHNTHHNHNNTNNNNHHNBHHNHNHTBTHTTNNNHNNTNBNNNHNN
NNTNNBTNTHNBNNTBNHHTNNNTNBHHTNHNNBBHBNTNBHTNNNTBBHNNTNNNNHTHBNNNNBHNNNHHTNHHBNNHTBNNTBNBTBNTNNTTBNNB
NTBHNNBNBTNTNHNNNTTTNBNTNHTTHTNTBHHNNBHHNNNNTHNTNNHTNBBNHNNHTNTTNTNNNNBHNTTTNNHBNBNNHNNBTNNNNNNNTHHN
HTNNNNTNTNNTNTNNBNNNTNBNNHHNHNNNNHTNNNTTTNTHTNNTNNTTNHTNNBTTTNNBBTTBHTBNNHTTNNNNNNTNBHTNHBTNTHNBNNNN
TTNHNTTHNNNTNNNNHNNNTNNHHTNNHBTTBNNBTTTNHHNNNBTHTNNHNTHNTNBTNHNBHTHNTBHNNTTBHHBHNNTNHHTNHHNTNNNNBNNH
HHNNTNTNNNNHHBTTTTBHNTTBTNTNHHNTNNHNNTNNNTNTNNTNNNHNNNHBNHNNHNBNNNBNNBNTNTNNNNNNNHBNNTNNNHTNNNNNNNBN
NNNHBNTNHHHNHNBNNHNTNHNNHNNHNBNBBNNBNNTNHTNNNNNNHTNNNNNNHHTNNNHBHNNNNNTHNHTTHBBNTHNHTHBNTBNNTNNNNHNN
NNHNHBNNNNBNTNTTNHBHBBNNHHBNNTNHTNHTNNNNNHBHTTHNNNBNBTBNTTTNHNNTTTBHBNNNNNHNTNNTTNNTBNHNTTNHHBHNNNNN
TBNTHTNTHBNHBNNTNTHHTNHNNNNNBNTTNHNHNTNNNBHHNNTTHNNNHTTTNNBHTHBBNNTNTTNTTNNBNNNHTNTNHNNHNNHNNNBTBBNT
NNHBBNHBTHTHNNHHNNNNNTHNTNTHTHNTBTNNNTNNTNNHHNNNNTHNNHBNTNNNHNNNNNHBTTTNNBTHTNHHNBBNNTNNNNTTHTHNHHHT
TNBTTNNNNHHNNNNHBHTHTHHTTBNNHNNHNHNTTNTNNTNNHNHHNTNTHNHNBNTNTTNBNNBHNBBTNTTTTHTTHTNNNHTNNHHHTHNTBTNT
NNBNNNNTNNNHNNNHHNHHBTTTBHNTNTBTTTNNNNNNBNNNBNBNHTNNHTNHNNHHNTTNNNNNBNTBTNHHHNNTNTNNHNTHTHNHBHNNTHHN
BTNNNNHNTNHHBBHNNTTNTNNTNHNHNBNNNHNNNNNBNNNTTNNTHNHHNBBTBTNTNHBBHNNNTHNTNNNNHNNNNNNBTNHHHBTBHBTTNNNN
NNNNTNBNNBHTBTHNNTHHNBTNNHTNTHHHNNNNTNNHTHNHNTTNNHTBTNHNHNNHTTTNNHHNTBBNNTNHNHNHBNNNTNNNNTNBHHHNBNTN
NNTTTNHTHTNNTNNBBHNTHBBTNHHBNNNHNNNNNNNTHHNHNNNBNBNNNNTNHNBHNNNNNBTNTTNNTBTTNHNTNNHNNHHHNBNNNNNBNNNN
NNNNHNTTTBTNBNHTHNBHNNBNTNHNNNNTNHHHNTHHHTHNTNHNTNNHTHTBNHNHHNTNHHTNTBNTNNTBHBNTNNTNNTNNHNHTTNNNHTNN
TNBHHNHNTHTNBHTTTTNNHHNHNNTTHNNNNNBNTTNNBTNTNNNBNHNNNNNNHNNHNNHHTNNBNTNHNTHTTNHNNNBNHHNNNHNNNHBNNTNN
NNNNHNTBNTBTHNHNNNHNBTNHNNHNHTHHNNNNNNBHHHNNTTNNHTNNTBNBNHTTNBNHHNNNNBHTNNHNNNTTNNTNNNTNNBTNNNHTTHNT
NBNNHTNNNNHHNHNNTHBHNHNTTNTHNHBNHNNTNNNNNNHNHHNNHNNTNHHHHHBBNHNHHHNNNNNNTNNNHNTTHHHTNBTNNHHBNNTNNTNN
HNNBNNNNNNBNNBHHHHNNNHHNTTHNNNNHNTHNNNNTHTNNNTBNNHBNNNHNNBBNTNNNHNNTBHNTNTNTNHBNTTNNHNNNBTNNHNHNNBNN
HBHBHTTNNNNTNNTNNNHNHNHNNTTBNBNHHHNNNNBNNNTTNNNTHNBBBTTBNNNNNNHNNTTBTHNNHNNHNTBTNNNTHNNTNTNTHNNTTHNN
TNTHNNTNNNHBNNBHTNHHNTNNNBTBTNBHNHNNNNNNNNNNBNBHHTNHNNHTBTTNNHTHHNNNNNNTBNNTNNNTTTHHNTTTNNNHNTNNHHTB
NTHNHTHTNNHNNNHNHNNNHHNBNNNNNNNNNNBTNHNTHBHNNTTTNNHBTHHNNHTHBTTHNHNNTBTNNNTNHNTNNNHNNTHNTBHBNTNHHTNN
BTNTTHTTTHHNNTBNNHTNTHNBTTHNNNNBNNNHNNNBNBNNNNHNHHTTNHHNHNNHTNBNNTNBTTTHNTHTNTNNBTNNHNHNNHNNNTNNTTBN
HNNNNNNNHHNTNNBBHNTNNNNTNNHNHHNHTNHHNNBHNNNHHNTHNNNNNNBNBTTHNNNTNTNHTBNTNHNHNNTHNNNNNNHHNNTNTHHNNBTN
NNBNNNNNNNHNNNHTHNNTNTNHHNNTNHNNNNNNNNNTNTTNNNNTNTNHBNBTNHNNBNTTNNNNTNNTNNNBNNBTHHTNBBTNNNTNTNTBNHTN
NNNHTTTNTNHNNBHNNTNNNHBNBNBNNNNNNHTTBBTTBBNTNNNNHTNNHNNBTNTTNNNTNNNNTNNNNBTNNNHNTHBBNHHHNNNNTNNHNNHB
HHNNNHHNTNNNTNTNTNNNHNTTTNHNNNNNNTHHHNNNBHTBHNTHBTNHHBTHBTNHNBTHTNTTNBNNNBHNBNTBTHNNHNHNNNNNNNTHHHNB
THNBNHNNBNNTBNNHNTNHNNNHTHNTNTHNHTTNNNHTNHTHBBHHNNNNBNTNTHBBNBNTHHNNTHBNTTNNTNNHHNNTHTNTHNHTNNHNHNHN
NHNNTTBNBNBHNTTTNHHTNTNHNHHHBNNTNNBNTNHNNHBNNHHTTNTHNBBNHBNNHNTBNTTHNNNTBTNTHNHNHTNBNNTNHNTNTTNTNHBH
BNHNHNNNNNNBBHHHTNNNHNHNBTNNNTNTTTNNBHBNHNBBBNNNNNNNNNNTTTTNBNNNTNNHNTNNHNHBHNTNTNBBNNBTNHNNNNHNNBNB
NHNNNNNTNTNTBNTTTNNBTTBTTNHTTNBTTNNNNBHNNNNNBTNNNHHTNNNNNNTHNNNNTNTHNTNNHNNNNHBHBNNNNTTNHNNNHTTNTNNN
BNNNNNNTTNHNNNNHNBHNNNNBNHNNNTBNNNNHTTNTTNNNHBNHHBBHNHHNHHBBNNNTNNNNNBNTHNNBNHNNNNHNNTNNHNNNNBTNTTTT
BTNNNNNNNNBNNHHBNHNNNNNHNHHTTNNNHNBHTTNBNTNHNNNHNNNNNHHTBTBNNBNHNHTNNNTHHHNBTHHNBNNNTNNHNHHNTTNNNHNN
TNTTNBNNTTHNBNNTTTNNNNTNNBNNBHNBBHTTNTTNNHNTNTNHNNHNNTTNHNTNNNNBNHBTHBNHNNNNTNTNNNHNTTTNNTNTBNTTHNNN
TNNNTHNNHNTNTNNTTBNNNNHTNHNNHNHHNBNTNNNNTBBBNHNNBNHNNHBHNHTNBNNTNNNNHNHNNNBNNHTNBNNHNNNTTNHBNNBNNNHN
NNNHBNTNTTHNNNNHHBNHNHNHNTNBTNBNTNNNHTHNNNNNHBNNNNNHNBHHNTTNTHNBNTNNNHBHBHHNNNTNTTNHNNNNNNTNTHBNBTNN
THHNNNHTNNHHTNBNHNNNNTNTHHNBTNTTNNTNNNHTTNNTTHNNNNNHNTNNBBHTTBNNHTBTTNNHNNNHNNHNHNNHTBHHNNNBTNNNNHNB
NNNNTBHNBNBNBTNNHHHBNBNTBHTNTTNNNTHNHTNNTHNNHNHBNBNTBNTBTTBHNHBHBNNTNNTNTHBBHNNHHNTHTTNNBHNNTHNNTNTB
NNNBNNHTNNNNHNHBNTHNNNBTNHNNHNNNHTTNNNNNBNHNTNHHHNHHNNNNNNNHTHNNNNNNNNNHHNNNTBHNTBTNNNNNBHNNNHHNTNNN
NNBNHNTNHHHHNTTNTTNHTHHHNNHNHTBNNNNNTNNTNNHHBTBHNNTNBNNHNNTNNBNNNNNNNTNNBBHTNNNNTNNTBTNBNTNTBTTTNNHH
NBHTTBNHNTNBNHHTBBNNTBBNBNBTNTBBTNNTHBNHBTBNNNTNHNNNNTHNNTNTHBHTTNTNHTNNNNTBHNHNTTBTNNTHNHHHNBNHBHNN
NTNNNTHNNNNNHHTTTNNBNTBNHHNNNHBHBBNTHNHHTBHNTHTHNHNTTHNHNTHTNNNTNNNHHTNHTHTHNHTNTNNNHNNBHBTNTTTNTNNN
BBNNTTHBNHTNNNNTHNNNHNNNBHBNNBNHNBHTNNTNNNHNNNTNNHTTTTNNHNNTHTNNBNHTNBHBNTTBNHTHHNNBBTNNNBNHTNTHTHNH
HNNNNTTTNHNNNHNNHNTHHNNTTNNNNHTHNHNNHHTNHNNBNHNNNNNNHNTBHNNNNTNNTNTHHNTNNHNNNTHHNNHHNHNNTBNTNHNHBNNN
HTNNNNTNNNNHNNBHNNBTHHHHTHTNBNBNHNHNNNNTNNNNNNTTNNHNNNNNHNNTBHTHNTHNNNNNBNBNTHBTNHNTTTNTHNBNBHTNBNHB
TBHHNNBHNNNNHNNNBNTHBNNNHTHHNNBTBHHNBNTHNNHTNNHNNNNNNNHNHTHHTTBNNNTNHNNNTNNHNNTHBNNTNNBHNNBNNNNBNNTN
NHNNBHTBNNHNNTNTNTNNTNNHTBNNNNNNNNNNNNNTNTHNTNNNNTNBNTBNNBHHNNBNNNNBNTNHHTNNTHHNNHHTTTHNTTBNNNHNHHNN
HTTNBNNBHBNNNNNNHNNHNHNNNNTNNNNNNNNHHNNNNTBHTTNNHTNBTNHBNNTHBHNTNNHNHNNTTNNHNHHBNNHBNNHHTNBHNNTHNNNH
NNTNNNNTNHNNBNHNTNTTBNTHTTNHBTNTTNHNNTNBNNHNTNHNTNBNHBNBTNTHBNTHNBTTNNHHHTNTNNNBTNNNNNNNNNNTNNHNNNHT
BNHHHHNNTNNHNNNBHNTHNNTTNHNNBNNNNTNNTTBNNBNTNBNNNTNTNNHHHNNHNNNNNNBHNBTTNNHNNHTNNNNTNHNNNNNNNNBNHBNH
NNBNNBBNNNNNNNHHTNNNBHNHNHNHTNNHNHTBHBNNNHHNNNTTHHBHBNNTBBHNBNNTNNBHTNHHNTNTNNTHNNBTBBNHNNTHTTNNNTNH
BHTTHTTTNHBNBTTBNNNNBBNHHTNTNBNNTHNTNNNNTHNTHNNNTBNTNTNNNNHTNTHNNBNTTHHHNNTHNTNTHBTTTHNTBNNHBHHNNBTT
HTNHNNHHNTNHNNHTTNHTNTHNNTHNNBTHNHTNNHBHNHTNNTNNNNNHHTNNNNNNNHBNNHHBHHHHHNNNNNNNHNHNNNTTHBTHNHNNNNTH
HBNHNBTHHTNNNNNNNNNHNNNNNBHNNNTTHNNBNHHHBHBHNHNNBNHNTNBHNTNNTNTNTNBNNHTTBNNNHNHBHTNNTNNNNNNTNNNNTTHH
NTHBNNTHNNNNNTTNHTTNTHNTHNNNNNHNNNBNNNNNHTNNNNTNHNNTNNNTNBTNNBTHNNNNTNNNHNNHTHBNHHBTNHTNHNHNNHNTNTBN
HNTNNNNNNNNNHNNBTTHNHNNNNNHTBNTNNNNNNNHTNHNNNHHNBTNHNNTBHNHNTNNNNNTNTHNHTNBBTNBNNTBTHTNNNNNNNNTTNNNB
NHNTNNTNNTNHNTNNNHNNNNNNTBHTBNTHTNNNNTHTNHNBNHNBHTNNNNHNBHBNTTNNHNBHNHNNNNHNHTNNNNTHNHNTTHNHNHNNNTBN
HHNNTTNTTNTNNTNNNNNNNNNNHTNNTTTNNNTHNNBNBTTTHNTTNNBNHNHNNNTNTTHNTNTNTNNNBNNNNHNBTNNNNNTNNNTNBTNTNNNN
NBHNNNNNNHTBHNHTTHTTTNBBBNNNNNHNNNNNTTNTTHNTTHNNTTNNTHNNTBNTBTNNNHNNHBHNNNNNHNNNHNNNTNNHNNTNTHHNNHNT
NHHHBNHTHNHNNNTNNTNNTNHNNNNNNNNHHNNTNNHBTNHTNNTHTNNTNHNHNNNTTTNHNNNNHHTHHNTBTHBHNHHNTNNNBHHNTNTNHNBN
NNNHNNNTHHBTHNHHTNNNNHHNTHNTTNHNTHTNNTNTNNHHTHHBNNTNTTHTNTNHNBNNTNTNNHHNHHBHHTHTBTNNTNNHNBBTTTNHNNHT
NBTBTNTTHTHTTTBNTNNNNBNNNTHNNTHNNHNHHNBTNBNNBTHNNNNNNTHNTNNNTNHNNNTHTTTNNHNHHTNNNNHNTNNTHTBNNTNNNTNN
NNNHNNNNHNNNNNBNNNNTHTNHNHBTNBNNBBTTNHNTNBNNBNNNTNNHNTNNNNTNNTNNTTNNNNNNNNHNBTNNTBNTTHBNNNTNTNTTNNHN
NTNTNTHNNHNBHNTNHNTNTTTTNHHHTHNBNTNTNTTNTNNBTNBBNHBTTNNNTHTNHTHHNTBNBHNTNHNNHNNNNTNNBNHNNHNNNNNTTHTB
NNNNTHNHTNTTNNTBNNBNTNNNHTNBTTNHNBNNNNTNNNNHTHNNNNTTHNHNNNNNHHHNNTTNHHTHNNBNTBBTTTNBNNHTTNHNNBTNNBTN
NBNTTHHNTNNHNHNBHNHTHTNHNHNNHTBTNNNTTNNTNNNNNNHHNTNNNNNTNNNNHNNNNNNNHNNHNNBTNHNNTNNNBHTTNTNHNNTHBNNB
THBNHTNNNNNNNNHHNNNBHNNNHNNHHNTHTNNNNTTTHNBNHNBNNNNHHHHNNHNNHNNBHTNTNHTNNTNBNHHNHHNHTTTTNHNNTNTNNNHN
HNNHTBNNNNNTNNTNNHTNBNNHTTBNTTTTTTTNNBNNHNNNTHBNNNTHHHNNHNHTTTNTHHTNNNBTNNNNTHTNNNNBNTHHHHNNNNNNNNNH
NNTHBTNTBNNHNTBTNHTBNNTHNHHHHTNNNNNNNNNNTTHBHNTTBNBHNTNTNHHHTHNNHNTBHNNBNTNTNNTNTTHBNBTTNNNTHNTTNNTH
HHBHTTNHBNNNNHNTNTNNNHNNNHHTNNHHNBNNNTNTHHNNTNNNHTNNHNHHBNTNTBNBNTHTBHNNBHHBNTTNNNHNTBNTNHTHHNNHNBHB
HNTTHTHNBNHBHNTNBTBNNNNNBNNBNNNHHNHNNHHTNNNNNTBTTTHNNNNNTHNNBNNNTNTNNTHHBTHHHBNBTNBNNNTNNNNHNHTNHTNT
TNNHNNNNHHNTTTNNTHHNNNHNBTNHHNNNNTNHHBNHNTNHNNNBBNNNHBBNNHNBNHNNHTTNBNHNTBNNTBTTNBNHHHNBNNTNHNHHTTBN
HNTTHHHHNHTHHTNHHHBTBTNNHNHNNBNNHNHNNHNNNNNNNBNNHNNNTBNBNTBNHTNBBNHNTNTHNNHNNNBHTNNTNNNNNNNNTNNTNNTN
HTNHNNNHTNNNTHHNHNTNNTNHTNNNHNTNHNNTNHNHTHNNTHBNNHNHNNNTBNNNNHNTNNBTNTNNTBTHNNHTNNHTHHNNNNNBNNNHNNTT
