(15, 57)
NNNNTNNNNHNNNTNNNHTHNBNNHNNNHHHHNHTHNHTTNTNTTNNNNNNNNNNNNNNTHNHBNNNBTTHNNHNBHNHHTHHNHHNBNNNNNNBTHBTB
BHBTNTNNHNNNNNNHHNTBNTNTTHTTHHNTNNNTNNHTNTTHHTTHNHHNHNHNHTNNHHNNNBNTHNNTHNBTNHTNNNHNNNNTNNTBNNNNBBHT
NBNTNNBHTTNNTNBNNNHBHBTTTNNNNNNTNNHNHHTHHTTHNHBNHNNBTNTHNNNNNNNNNBTNNNNBTNNNHTNHHNHNNBNNBTHHNTNHNNBB
HNNTNNNBNBNHHNNBNTNNHTHHTNHNNNBNHNNTNNNNHHNTNNTTTHBHTNNBHHHNTNNTNNNHBNNNHNTNHNNNTNTNNHNTNNBBTHTNTTNN
NNHHBNHNNNNHNNNHNNTNTHHNNNNNBNTTNTHHNNHNNTHHHNHNBHTNNHTNNNHBNNHNBNTHNNHHTBNTHNHNNBHNNNHNNTNNBNTTHNTN
BNNNNHHTNHNHNNTTNHNBTBTHNBBNNBNNNNNNNTHNNNNTNNNBNNTNNNHNNNNHNHNNBNNNNTHTBNHBHNNNTNNHNNNNNNHBNTTHNNBN
TNHNNTNNNHNBNHHNNNNNBTNHNNNHHBNNHNHTNNNNNNNNTNNBHHTNNNNHNNNNNTNNNNTHBNTNNNHNNBNNTTNNHHHBTHBTNNTTNHNN
TTNNNTHHNHNTNTNHNNTTNHNNHHNNHNNTTBBNNNNHNNHNBHNNNBHNTBNNHHHNNBBTNHNNBNHHNBHHNHHHBTNTTHBTNTNNNHTHHHHB
NHTNNNNHHNNNHTNNNHNNTTNNNBNHNTNHNNNHTNNNTHNNHNBNHNHHNNNNNNNNNHBNNNHHNNTNTHTNNTNHHTNNNNNTNNTNNHTNTNNN
TBBNNNTHNNBHNNNHNNTHTHHNNNTNNBNTNHNNHHBBNTNNNTNNBNBHTTBHNNNNNTHNNHNNNNHNBHNNHTNHTNNNNBBNNNNHNNNNNNHB
NNNBHHHNTHNHHNNNNBBHHHTNHNBTNTNNBBNNNTTNHHTNNNNHNNHNNTTNHHTTBNTNHHTNTNNTNTHHHHBHNBNNTBNNNNHNNHHNNBNN
HHNNBBNNNNHNNTNTNTNTHNTTHNTBTHBNTTHNTNHHNHTNTHHTBNHHBNBNNNNBNTHBNNNTNHHNHTTNNNNNNTNNNNNTNTBNNNHTNTBT
NNNHNNNBHNHNNHNNNTNHHBHNTTBNHNTNNNHTNNTBHHNNHNNTNTNHTTTTHTNBHHNBBHHNNNNHTTNHNTNNTHTNNHNNNHHNNNNBHTNN
NHTHHNHNHNNHNBTNNNNNTTTBNNNNNHNTNNNTNNNHNHNNHNNNBBNNTTNTTNNTTHBNNBNHNNTNNBTNBHTTHHTNTNNHNNNBNNNNHTNN
HHNHTBTHHNNTTNNBNBNHHNHTNHHBHNHNHHNHNTTTNTNHTNBNNNHTHNBTHHTNNNHNNTTNTNNNNTNNBHHNTBNBNTNNNNNHTNNHHNBH
HHBNTNNNNNNBNHTNHNNNNTTTNNNNHHHNNNNNNNNNBHHNTTNNNTNNHHNBTNNNHNNTTNHBNNNTHHTNNTNNHHNHNTTNNTHNNHNHTBBN
THNHNHNHBNNNBNTNBNHNTTNHNBTTBNBTNNHTNNTNNTNNNNNNNNNBNTTNTTTBTNNTNTNBNBTBNNNNHNNTNNNHTHNHHNNNBNTTHHNN
TNHNNTNNNHNNNNBNNHNBNNHNNTHNHTTNTTNNNNHTTHTNTTHNTHNTHHNNNHTTTNNNNTNNNNHNTNTNNTNTHTBHNNNNHNBNNTBHNNBN
TNHHTHNTNTBNTNBHNBHHHHHNHNNNNNNNTTNNTNHNNHHHNNTNTBNBHNBTNHNNNNHHNNTTNNTTHHHTBTNNNTNNHBNNHNNNTNNNNNTB
NNHTNHTHHBNTNTNBNTNNNBNNNBNTHHTNTTTNNNHNNHNNBTNNNBNTNHBHNTBBHHTBTNHTNNHNNHTNBHTNNNNBNHNNNTBTNNNHNHTB
NTTNHTHNBBHBHTTHNNNTTNNNNTNNNNNNTTBHNTBHNBTNBHNBHNHHTNNNBNTBNNNTTNBBNNNTHBTNHNHNNTNNNNTBHNTNBHBNTHTT
NNTHTTHNNNNTHNNNHTHNHTNHTNNTTNNNHHHHNNHNTBNNNBNNNNNNHHBNTTHTNNNNNNHNTHNBTNHNNNNTTHBNTNNNNTHBNBTTBHNN
NNNNNNNTNHTHBHNHNNHNTTTNHNNHNNNNNNBTNNNNTTNNNTTHNNTTNNNTHNBTNBHNNHHBNNNNHNHTHHNTNHNTNTTHNBTTHNBHTHTH
NHTNNNNTNTNNNNTNHHBNNNTNNHNNHNNNHNNBNHTTNNNNHHNNNBNTTNNNNTNNNBNNNNTNNNNNNTNHHTTTNHBHNBHNHHNNHNNTTNTN
HHNNNNBHHNTHHNTTNTNNBBNTTTTBTHTNNNHNBHTHTNHNTTTHNNNBHNNNNHNNTBBHTNTBHNTHNNTHHTNHBBHNNNHHTTNNNNHTHNNN
TNNNNNHNTHHNHNTNTNNNNTNTNNNNNNTNNTNHNHNNNNHTNNHNNNTBNHBBBNNHNNNNHHNHTBNNNNNTNHHTBNNNHNBNHHTHBNNNBNNN
NNNNBBNNTNNNHNNNNTHBNNNNTTBNTTBNHTBHNNNHNTBHBNNNHNHTBNNNTTNHTTTTHNTTNNTNNNTNNNNHNNNNTTNNNNTNHNNNNNNT
TNNNNNNNTBNBNHNNTNNTNTNHNNTTNNNTBHHTNHNNTNHNNNTNHTBNNNTTTHNTBNNNBNTHHHTTNNNTNHHTTHNNNNTNNHTHHNHNNTTT
NHTTTHNHHBTNTNHTNTTNHTNTHHTNNNNBNNBHNHTHNNNTNHNTBNTHBTNBNNHTTBNBNHHBNNHNHTHHBTNTNNHBHTNHNTHTNTTNBNNB
NHNNNNTHTHNTBNNTNBNTNTTTHTBHNNNBTNHNNNHNHTTTNHNNTHTBHNNNNNTNNBTTNNTNNHTNTNTNBHTTTNNNNNNBNHHNNBHNTBNH
BTNHNTNNNHNNNNHTBNNBNNNNNNNNHTHBNHNNNNNTNTNNNTNHHHNHHNHNBBNNHNTNBNNBNBBNNBTBBBNNNNNNHNHNNNTHNNNNNBTN
NNNNNHTTNNNNNNNNNHTNBNNNTNNBTNNTHHHNHNNHTHNNNTBNNHNHTHNNNHTNHTTHTNNTBNTTNTHNTBTNHNNHNHBTHTNTTNBHTHNN
NBNNNHNNHTHNTHNHHNNHTHNTHNNHNNNNNBNBNBHNNHNHHTBNNBNNHNHNBNTHBNNNHTNNNTNHNHNNNBNHBHNBNHNHTTBNTNHHHHNN
NNNHNNHBHNNNHTNHTHTNNNTBBNNNBTTBTTNNNBNTHHNNNNNNNNNTHTHTHHTTNNNNNNNNNTNNNHHNNBNBNBBTTNHTHHHHNHTNHTHN
NNBNTNNTNHNBTBTNTNNHNNNBBBNNTNHHBHNNTHNNTTNNNNNNTNTBNNNBNTHNNNNTBNTNHBHNNTHTBNTNBTNNTNHNHNNNNNBBNNNB
NNNTNBNTNNNNNTNBBTNNBTNTNTNHNHNHHNNNTNNNNTNTTTHNNNTNNHTTBHTTHHNNTNBNNNTNHBTNTNBTTNNHHNNNTNNNTTNHTHNN
NBTTTHNHTNTHNHNNHNHTNNNTTNTNNNHHTNNBNNNBNHNNNTHTNTNBNNBNNHNNBTNNTBBHTTNNNHHBNNNNHNHHNHHNHNTNNTNHNHHN
HNHNHNNHNNHTNBHNNNNNBNNNTBHHBTNNNNBTTNHHHNHNNHHTTNNNNNNNNTNHNNTNNTTNNHNNBTHNNTNTHHTHNHBHTNNHNNBTNBTT
NTNNNHHNBNNNNNNNTTNTBNTNHBHBBHTTNNHTNNNTHTHHTTNNNNNNNNNNNBHTBTNNNHHNHNBNNHNTNTNNNBNHNNNNNNNNNBNHNNNN
NNBBTNTTNTNHNNNNNHNHTNNHNHTTNNTTNNNNNNNTTNTHTNTBNTNTNNNHNTTNNNTHNNTHNTNNTHHNNNHNNTTNHNNNNNBHNNNNHTNT
HHHBTNNNBNNNNNTHHHHNNHHTNBBNNNBNTBHTHTNNNNHNHHNNNTNTTNNNNNNHNTTBNTBHNNNNTNHBTNBTTBNTNHNNHHHTNNNNNNHN
HNBTTHNNHTNNNNHHTNBNHHHNHNBNNNNNHHBBNTBNNNNNTBTNBTNTTNNNHNBTHHHNHHBHHNTBNTBTNNNNNTNTHNNTTNBBTHBNNHTN
NNNNNBHHNHNTHNNHNNNNNNNNTHBHHTTBHNNHNBNNTHBNTBNBNTNNTHNNNTNNHNTNTTBNNHNTHNTNNTNNNNHNNNHTNNTTBHNTTHNH
NNTNNNHTTNNHNNNBHHNTNHTTTTTBNBBNBTBHHTTBNTBNNNNNNNNNNNNTTNNTNNNNTNHHNHBBNTNNNNNTTNHNTNTBNHHHNHTBNTHT
NBHNTTBTHTNNNNBNTNTNNBHTNNHNTNNNTTNNBHNTNNNNNHHTTNNTHNNBNHNNHNBTNNTHTTNTNNNNTNNTBNTHNNBNTBNNNNTBNNNN
HNTHNBNTHNNBBHNHNNBNTNNNNHBNTHTTNNNTNNNNNNNTBTNNBNNBTNTTNHNBTNBHTNBNNNHNTTNTNBNNNNNNNTHNNHNTTNNHNHNH
NHTTNHTNNNNNNNBHBTNHNTHTNNTTHNBNTNNBHNTHNNNNTBHNHHNHNNNBNNTNNNHHHHBTTNNHNNNNNHNNHNTTNNNNNNTNNNHNNTNT
NNNBHTHHNHNHNNTNTHNNTNTNBBBTTNBHTNNTHNNBHTNNNNNNBNHHNTNHTNNHNNHHBNNTNNNNTNBHNNBTTTNTNNTHNNNNNNTNNNHN
HTNHNHNTHNNBBNTNTHBNNTNNNNTNNNHHNNTTNHNNNTTHHNHNNNHNHTNNNNTTNTNNNNNNTHNNNNNNNNHNHHNNNTNTNNNHHNHNNNNN
TNTHNNNNNBHNNNTNTNNBNNNNNNNBHNHNNHHHHNNNTHHNNHBNNNHBBTTTHHNNNNTHBNBNBBNNNNHNHTTNTHNNTHNNTTHNHNTNBBBN
NNNNTHHTNNNHBHNHNNNNTHTNTNTHTNNNTBTNTNNHNNNTTHBTBNTNNTHHHNNNHNNNNTHBNTHTNBHNNNHNTHNNNNBTNNTNHTNHTHHT
HHNNHBTNNBNHNBTTNBHTBNHTNNNNNNHHNTBBTNTTNNHTNNTNHNNNNNTNNTHHTBNNNNTHTNNNNNNHHHTNHNNBNTNHNNHNNNHHNTTT
TTHTNBNHNNTBNTHNHTTNTNNNHNNBNNNHNHNHTNHBHHTNNNNTNNNNBNTHTHHNNNTBBNNBHBNBHNHNHNNNHNNHHHNNHNNTHTTHTTNN
NNNNNHTNTTNHHTNTHNNTHTHTTHNTNNNTNBNTBBHTNNNTNNNBNHNNNNTHBTNNNNNNBNTNHNHTTNNNNTBBHNTNNHNNNTHNTHTTHHHN
NHHNHNHNNBNHNNHNTNNTTHNNNTNNNNHHNTHHNHBNNNHNBHTNTTHNNNBBNTNHNNTHTHTNHNHNNTNHHTBHNBBNNTTNTHNNNNNTNHNT
BNNNNNNHBNTNHTNBBHHTNNTNHTNHTNNHNBNNTNHTNHBTBNHNHBHHTNNNNNHNNNNHHHNTNNNHNNBNHTBHHTNHHNHNNTHNNHNHTNTN
THNNNNNTNNTHNNNHNNNNNBNHNHHNNHNNTBTNNNNNNHNNNBNTNHNNBNTBNHHBNBTTHNHNTNNHHTNNNNNHNBNNTNNNTTHHNBTNTHNH
HNNBHHNNTHTTNTNTNBNTNTHNHTNHHNBHNNTNTNNTBBTHNNNNNTNTNNNTNTTNBTNTNNTNBTNHNNHNBNNNNHNTNTNNTNHNHNNHNNHT
NHNTTBNNBNTHNTBNNHNNHNNNTNNNNNNBHTHNHNNTHNBNHNNNNTTNHBNHTTNHHHTNBNNNTTNHTBNNBNHNHBTHBNHNHNBTNNTNNNNT
TNTTHTTHHTTBNBNHNNNBNNNNBBNNHHTNNTTNNTNTTNHNBTNHHNNNHNHNNTHNNHHNTHHBHNHNNNTNNTNHNNNNNNNHNNNNNTNHNTNT
NBBTBHBTNNNHNNNNNNTNBNBBNTNTTNNHNNNNNNNHNHNNTNNHTBNNNNNBHNTHTNBNHTTNNTNTHNHNHHBNTNNNBHNHNBNNHHNNNTNN
BNNTNNNNTBHBTNNNHTTNNNHTHNNBNNHHTNNTTNNTBTNNTHHNNNNNNNTNTBNNNNBHNTHHNNHNNTTNTHBBHNNNBNNNTNNNHTNHNHNH
NNNTTNTBHNNBNHNHNTTNNHNNNNNBNTNNNTTTTHNNHTTNNNNHTHNNBNNNNBHNBNTHTNHHNTTHNTHNNTTTHTTHTHHNNNNNHNBHBBTN
THNHNNHNNNBBBTHNNHNTHNTNNHTNNNHBTTNNNHNHNTBTNNTNBTTNHBNBTNBTNBNNHHBTTHNHNNNNNNNNNNBHTNNNHNHTNNNHNNHT
HNNNBNHHNNNHHNNBNNNTNTNTTTNBBNTNNBHTNBTNNTTHHHNNHNHNNBBHNHNTHBHTNNTNTNTNNHHNNNNNNTBHHNNNHNTTNNNBNTNN
NNHNNNNHHNNTHNNHHBBNNHTBNNHTNNNTNTHTNHBNTTTNHNHBNBHNHTBBTHNNTNNHBNTTNNNNNHNNTNHHNHNTNTHTTNTNBTHHBNNB
NHNNHBNHBTTHNNNTTTHBNTHNTNNHHNNNTNNNTTNHHNHNNNHNTNTNNTTNHBNNTTNBTNHTNHTNNNNBBNHHTNBNNNNNNBNNHHHHNNHN
NNTNNBNNNTNHNHNNNNNNNBTTNNNTNNTBBTNTTBTTNHNNNNTNNNNNHTTNNNBNHBHHNHTNNNTHNNTNBNTTNNHNNHHNTNNNHTNNNNTN
TBNNHNHNHNTNHHTNHNNNBBNBBNNNHHNNBTTNNNTNHNTTHNNHTNNNNNNNHHTNHTNNNBNNNHNNNBNHNNTNBTTNTTNNHHBHNTTHNBNH
NHTTNTNTNHHHBBNTNNHNTBNNHNTBTTHHNNTNNHNNNNTHHBNNNNHNNTNBTNTNNNTTNHNHBTHBNNNNNNNNNTNBNNBHTTNHNTBNHTBT
NNNNNHNBNTNTBHTNNHNTBTNHNHNNNNNNNNTNNHNTNNBBBNNNBBNTTNHHNTTNNBNNBHHHHHNHNTNTTNNNNTBNNNHNHBNBHTNBBBNN
NTNNHHTHTNNTHNNNNNNNNHNNBHNNNHNNTNTTBBNBNNBNNNHNHTNHHHNNNBTNNTNBHTNTBNNNHHNHBTNTNTTTTNNNNHBTTTNNTTTH
TNTNHBNHNNNNNNHNTNNHNHNNNHNTHNNNNTBHBNNNHHTHNTNBHNNNTBHTNHHNHTNHTTHHHBNNBNBHBNHTNNBTNNHTBTNTBTNTTHNN
HNNHNHNHBNNHNNTHNNNNNTNTNNNTHHHNNHNNHTNNNNHBNTTNNHNBTHNTNHNTNTBTTNHBTNNNTHNHHNNTTNNNNNTHBBNNTHHHHNNT
NNBNNBNNTNTNNBNNNNNNHTTHNHHNNNNBNHTHNHNNTHNNNNBTTTTNNNHNNNNNNBNTTHNNTNNTTTNNHTNTHTNTTNTTHNNBNTNNNNNN
NBNHNNNTHTHNTNNNHNNTHNHHTNTTNTHTNNHNTHNTHNNNNNNBNNBNNNNNNNHHTNHNNNNBTHNHBTNNBHNNHHHNNTBTBNNBBNNHNBTN
HHBNTHNHNNNHTTNNTTNBNTNNNNTTTNNTNNTBNNTBNTNTTNNNNTTNNHTTNNNHNNNHNHHTHHTNNNNNNTNHHNHNNTTNHBHBBHNNNNTT
HTNNBHTBTNBNHTBBNHNTNNHBTHNBNNHBHNTTBNNNBBHNNTNNNTNNHNHTTHNBNBHNTNNTBNNNHHBNNTHHHNHBHTNHTNHNNBTNBNTN
THNHTBBTBBNNTNNTHNNHHHNNNHHNNNNHBNNNHNBBNNBTTTHHNNHNTTNNHTNHNNNTTHNHNNNBNHNHNTTTBNNBNTTTNNBBNHTHHTBB
NHTNNNNTTNTTNHTTNBBTHTHBTTTNNTNNNNBHTHNNTNNNHHNNNNBNNNTTNHBTNNTNNTHHNNNNHNTBTHNHNTNHNTNNHNBHBTTTHNNH
NHNNTNHTHTBNNHNTNHNNNBNHNHHTNNHNNHNTHNTNNTTBTNHHHNNTBNTNNNNHNHNBHHNHNBNNNHNHTNHTHNNBNNHBNNNTNNNNTBHH
TTHHHHNNNBTNTNBNTNTNNHHHHNHHHBNNHTNNNNBTHNNHNNBHNBNHTHNTNHNNHHTNNTNNHTNNNNBNHNNNNNTHTNTNNNNHBHHNTTNN
BTTNNHHBHNTTTNNHTNNHNNNNTHNNNTTHNHTHNNNHNBHBHNNTNHNTHNNNHHTTNNTNTNNTBNTHNNHHNHNHNNNHNNHNHBNBNHBTNHNN
NNNHTNNTTNTNNBNNHNTTTNNNNNTHTNNBNNNNNTNNHNNHTTHTBHHNTNNTBHNNNTHTNNNNNTNNNBHNNNNBNNBNHNNHNBBNNBTNNHHN
NNNNNTBNNNTNTNTHTHHNTTHNNNTNNNTTNNHBNTHNTNHNNHNNNNBHTNTHNTHTNTNNHNHNBTNNNHNNTNNTNHTHNNTNTTNTBNNNNTNT
NHBNNBBNNNNNNNNNHHNTBHNHHHNNTNNTHTNHTBBNBHNNTHNNHTNNNNBTTNHTHNHNTNTNNBNTNNBNHNNNBNTNNNNNBNNNBHTNNHNH
NBTTHTNNHTNNNNHNTHBTNHBTNNBTBHHNNHNTNHHNNNBNNNTNHNNNNNTNTBNTNNHHHBNNNHHNTTTTBNHNNNNBHBNNHTHNBNTNTNNT
NNNTTNTNHHTBNHNNTNHHHNNTNBNHNNBNNHNNTNBNHNNNTTHNNNHTNNHNHNNTNNBNNNTTHTNNHHBNHNNNNNBNNBHHBNBNBHNNNBNN
NNTHTTHTNNNTNNNNNTNBNTNNNNNHNNNNNNHTBNNTBNNHTNNBHNTHNHHNNTHNTTNBNNTNNBNNNNNNNTNBBHHBNHHTTBHHNBHNHNNT
NHHNTNTNTHNHNHNHNNHNBNHNTBNNNHHBHNNNBNHTTHTNBNTNTHNHHTHNHHBNTNNTHHNNNTTHNTTNHBTNNNBNTBHNNTNBHNNNNHNH
NHHNBNNBHNNNNTNNTHNHTHHHTTBNNBNHBTTHNHHBTNNNTNNHNTNNHBHNTBBNNHHBNNTBNHTTTNBTHHNNHBHHBTNNHHBHNNHNBNNN
NBNNNHNNTHTNNBHNTHHHNHNBNNNNNNTNNHHNBNNHNNNBTBTNHNHHNNNHHNTNNHNNTHTHNNNTBNTTNHNNNHBHNNNNNNNHNTTNBHBT
NHTHTNTTHNNNNNNNHNHBNNTNHHNNNTHNNBNTNNNNHNNNNNNNNNHHTNHNNNHTNNTBTHNNHNBNNHNHNTBTTBHTBTTNHNNBNHNNNTNN
NHNBBNNHNTBNHHNNNHTNNTNNNBHHTTTNNNBTNTTTTHNBTTTBTNNNNNTBHHNBNBHNNNNTBNTHNHNHHNNTNHTNNNNNTHNNNHNHTNTT
BTNTTNNHNTNHTNTNNTTHBNNNTHNBHBHHTTNNHNNTBNNNNNNBNTHNNNNTNHNNNTNHNNNNNNNNNNNNTNNHNHBHHTNNHNTNTTNNTNNN
NNNTNNNTTTHTNNBNNNNNNHHNNNNHNTNNNTNNNHNBNTNNBTNBTTNNNNNNNNNBNNNTTBTHNNBNNNTTHNNBTTNHNNNHHTNHNHBHTNNT
NTHNNTHNHNNHNTTTNTHTNTNNBNBBNBNNTNHHTHBNNNHNBNNHBHNTHNNHTHBNNNTNNTTTNNNTHNTTNNNNHHNNTNNTNBNTBTNNHTNH
NHNTNNHHNBBHNTNNTNHNNBNNNBNNTHHHNNTNNNHTBBTTTNBNTTHNBTNNNNBBNNNHNHNTNNNNHTNTHTNTNTBBHHNNBHNBNHNNNTHT
NNHHHNNNBNTBNHNTNNNNBHTHBTNTNBNHNBTHNTTNBNTNHNHNNTNNHNNNNTNTBNNTTHTNNTNNNHHHHNTNNNNNNNNTNNNBHNTNNTNN
NTNBNHNTTNBNNNNTNNTNNNHTHNNNNNHHTHBNTTHNNHNNNTNNNTNHHNHTBTNNNBBNNHTNNNBHHNNNTTNTNNTBBNHNNTTHBBTNNTBT
