(58, 97)
NTTNNTNNHHHNBHNNHNBHNNNNNNNTTNTNNNNNBHNHNHHNNNTHBNNNNHNNNHTNNNNHNNBNHNNHNHBBNNNNNNNNNNNTTNTTNBNTHHNN
BNTNNHNBNTHBNTNNTNNTBTNNHNHBNHNTHTNBNHTBTTNNNNTNHNNHNNNHNNNTNNBHNNBBTNTNBNNNNTBHTNHNBNHBHHNNTTHNNNHH
HNNNNNHNNNHTNNHNNTNBHTNTNNTBNNNNNNHNNBBBHNHNNNNTNNTHNNNBTBTNTNHTTHTNNNNNBNNTBBNNNNBHNNHNHNTNNTHNBNTN
HHNBNTHHTHNTNNTNBNNBHHNTHTNHNNNHTNNTNTHHNTNNNTNBNHHHTHTBTHHBNNHTBHTTHBNNTNHHHBTNHHNNNNTTNNNNNNNNNHNT
NNNHTTBBBNBTNTNHTHHNHTNBNNNTTNTNTNHBHNNNTHHBNHTBHHNTHNHNNNHNNBHBTHNNBBNNNTTNHTNTNHNNTBTNNNNNTNNNNNTN
NNTNHNTNNNNNBHBNNHBNHHNHHNHTNNHNNHNTNBTHBNNHNTNHHTBHNNTTNNNNNTNNNNNNHTBNNHNNTBTNNNNBNHNNTNNNHTTNHNHN
HTNTTNBNNHHNNNNBNNTNNBNTHBTNHNBHHNNTNTNNHBNBTTHTNNTNBNNBNNBNTNNNNNNHNNTNTNNNTNNHBHHTNBTNTNNNNNTBNBBN
THNTBHHNBNTNTNNTBNHNNNTNHNHNHHNNBNNNNNHNNTHTHNNNNNHTNNNNHNNNNNHNNNTNTNNNNNNTHNNHNTNNNHHNNHTNNHNTNNNT
NNTNBNNTNNTHNHNHNTBBNNBTNHNTNHHTNNNTNNHBNNNBNNNNTNHTHHNNTNTNNBNTNHNTNHNNNBNNHTNTNNNNNNBNNNNNNNHTHNNH
NNBNNNNNNNHNTHNNNNTNTBHNNNHNHNBTNTNHNNNNNTBHTBNNHNNHBNTHNNTTNNNNHTBTNNTTNHTNTTNNHTHNNNBTNNNTNTNTHNNH
BNNBTNTTNHNNNBNNNTNTNNNNTHHNNHTNTNTBTNNNNNNNNHNHNNNHHHTNBHTTNTNBNBTNNNBHNNHHNTNNNHNTNNNNNNTNNNNNHBHH
HNNHNNHNTBNBNNNBNHBNHHBNNTBNNHNHBTTNNNNHNHNNNBNBNTNHNHTTHNBNTHNNBBTNNNHNNHNBNTHTHTHTNNHTTNHTTTNNBNBN
TNNBNNNNBNNBBTTTBNHBNNNNHNNNTNNNNNNHNNNNTNHHHNNNNTNNTNNTBNNNTTNNTTHNBNBHHNTTHHHNTNNHTBHTTTTNHNNNNHTT
TNBBNTBNNHTTNNHNNTNBNHBBTBHNNNNNHHHBNHHNBNNNHTTNHHTNHNBNNTHBNBTNNTTNHNBTNHHNHNNNBTNHNNHBTNNNBHNNHNNB
NNNHTNNNNNNNNTHNHNNHNNHNNTNBHNNNNNNNBTNHNNTNTTHNTHTNNNHNBBHTNBNNTHTNHTBNTHNNTHHTTNTNHBNTBHNNNBHHBHNT
NNTNHHTTNNNNNNBBBHNNTNNNTTHBHNNTBBHNTTBHHTNTBBNBNNTBHNHHNTBHTHTBNNNNNHNNNNHNHBNHNNHTNTHTNNBNNHNBNTNH
NNNBTTTHTHHNHBTNHBBHNNNTNNHNNNNNTNNHNNNTNNNHTTNHTHTNNNBTTNNNHTHHNNNNNNHHNNNHTTNNNTNNNBBBNNNTHTNNTNNN
NNTTNTNHNNNNNBNTNNHNNNNTNNBNNNTTNNNTHNHNHTBHNNNTNTHNTNNTHNNTNTNNNNTHNNTNHHTTTNNBNNBBBNHHTNNNNNBTNNBN
TBNNHNNHHHTTTNBTTTHNBHTHNNNNHTHHHNNNTNNHNBTTTBTHNHBNNNBNBHNNTNHNHNHHNNNNHNNHHTHTNTBNHNNHNTBTHHNNNNTN
NTBBHHTHHNNBNTNNBNHHBNHNNNTHBHTTNNNHTTNTTNNHNNNHNNBNHNNNTTNNNNTTHNNNTNNNNNNHBBTHHNTNNNTHHBNNNHHNNHHN
NNNBHTTNNNNNNNTHTBTBTTTHBTTTTNTNNHNNTNNNTTTHTHNNBNTNHTNTNNTNHHNBNNBHNNBTTTNHNBNNNNHTHHTHTHNHTHTTHTNN
TNNHNTTNHHHNNNTNNNTTBNHNHNNNNTBNNBHNTNNNNBNHNBHNNHNNTTTNBNNNNNBNNHTNNNTNTNNTNHNBNNTTTNTNNBNNTNTNBTNT
TNNTNNHHTNNNNBHTNTNNNNBHNHNTNNNTHNTNHTNNTNNNNNTNNTHBHNTBBNNNNNTNBNHNBNNNNNNBNBNNNNNNNNTTNNTNTHHNBNBN
TTNNNTTNTHBNNTNTNTHTNHTHHBNHNNHHHNTTNBNBNTTNHNHHHNNHNNTNHHTTTNNTHNNNHNTHNNNNTNTNNTNNHNTBNTNHTNTBTNHH
TNNNNNBNBNNBNNTTNHBNHNHNNNNNNHNNNNNTHNNNHTNNNHNNTBHNTHNNNTNNNTHNNNHTNHNNNNHTTNNNNNTTNNHHHNHBHHNHBNHN
NNNTNTNTTNNTHHNTBNNNNBNHNNHNTBHNNHNTHTNTTTTNNNNNNNNHNNBTNTBNTHHNHHTBTNHTTBHTNHHTNNTNNNNTNNHHNHNHTNHT
HNNBBNNTNHTHNTNNNNHTNNNNNNTHNBBNTNNNNHNNNHNNTNNTHHNHHNHNNNHTHTNTNTNTHNNBNNNNNNNHTBNTHNNNNNNNNNNHTTNN
NBTBBNBBNNBNBTHTTNNNNNNNNBNHTNHNNTNNBTNHNBHNBNTHHTBTTHHHHHHNNNHTNBNHHTNNNHBTNHHNNTNNTHNNNTNHHHNNHNTH
NNNNHHTNHBBNNHHNHBBBBHTTNNTNHHNHHNNTNHTBTNHNNHNNNHNNBHTBHNNTNHHTHNBBTNTBTHNNHBTNNNNTNNNBTTBTBHTNNNHH
HNTNNBHHNNTNNNNTNHNHNHNNNNTHNHTHNBHTHNBTNHNNTHBNNNHNHNBBNHTNNNHHNTNNNNTBNTTNTNNTNTNNHBTNHBNHBHNNTTBT
HNNNHTNTNNHNTNHNHHNNNNTHNNNNNTTHHBNNTTNHHTHHTNNHNNNNNNNNBTNNHTTHNTNBTNHHNNTTNTHNHBTHHNHNNHNNTTTNNNHT
NTHNNNNNNNNNHNHNTNNNTNNNNNHTNTTNBNBHBNNNNNHNTNTNNNHBNHHHHNNNNNHTNHNTTTNNHNHBNNNTNNNHNBNHBNNBHTTNNNBT
NHTNBNBNHNBNNNTNTTNNNNBNHTNNNNNBHNNHHBTBNHBTHNHTHHBNHTNHHBBHTBNNBNHHHNTHNHTBNTHHHNNHTBNBNTNBNBNBHBTN
NNHNHBBNTTNHBTHNTTNNNTTBNTNHNHNBNHTNHNNNHHHNNTNNNNBNNHNNNTHHTNNNNNNHNTHNHNHBNHNHHHNHNNNHHNNHTNNHNNHN
HBHNNNNNNTNNTNHBTTHNNHNTNBHNBHTNBTHNHNNHNNBTNNTNBNTNHTHHHHNNNNNHNHHNNNNTNNTNHNHNHTNNNNNNTNTHHHBNHHNH
NNNHHNBTBNTNNNNTNNHHHNTNTNHTNNHHHTTHBTNTNNTHNNNTBTNBHNNNTNHBHHHNNHHTNNNHHHNHNHNNNNNTTNNTBNNHNHNBTTHN
HTTTNHNNNTTBNNNHTTTNNBBBBNBBTNBNNNBTHBTHHBNBNTTNNNTNTNNNBNTNTNNBHNTTNTNTTNHTNNNHNHNNHNNNNNTNNHNTNTNN
THHTBHNHNTNBNNNNTTNHNHHBBNNHNHNNNTBHNNNNTNNHNHNNNNNTTNNBNNNNTTNTTNHTTNBNNNNNNHNNNNBBHBNTNHNNNHNTNHNN
HNHNNNHNTTNNNTNHBHNNHHTHNNNNNNNNTBNHNNHNHNNNTNTBNHNHNTHHHNBHNTNHNBNHNNNTHHNNTNBTTNTNHTNHTTNHTHTHNBHN
NBBNNHNNNNNNNNTHNNHHTNNNHNNNTNTHNHHHTTNTHTNHHHHBNHNNHHNTHNHNNHNHTHNNHNTTNNBHHNTNNBNNHNHBTNTHTTTHNNNN
NNNHHNNHNTNNTNTTHNNHNNNNNNHBHNHNHTNHNNNNTNNBTHHNBNNNTHTNTBNNNHTNNHTNTNBNTBBNNNTNTNBNNNBHHTNNHBTHNTNN
NHTHNNNHTHNNNNNBTTHTBBNNHBBTHBNNNNTTNBBTNNNNNNTTTNNNNNNNNNTTHHNNHNHHHTHNHNTTTTNNNTNNTTTBHBNNHNNHNNHB
BNTTTTNNNBHTNNNNTNNTBBTNNNNNNNHNNNNBNHNNNNTNNNTTNHBTNHTNNNNNTBHHNBNBNNHNNNHHBHNHNNNNTTHNHBTNTHTTTNTH
NNNNBNNTNNNNBTBTBNNTTTHNHHTNHNTTNNNNTNTHTTTNHNNBTNTTNNNNHNNTHHNNNTHHHHHBNNTTNNHNBTNNNTNNTNTNNBHTNNNN
TBHNNNNBHTBTHHNNNNHBBNHHNNNNTHNTNNHTNNTTBHNBTNNNNNTNNHHNHTNNHNBTNNNNNHTTTBNNHBHNTNBBNTNNBTNTTTNTHNTT
HHHNNBTHNNTHNHHBBNNBNTNTHNBHNTTTHNNNNNNNHNNNNHBHNTNNBHTHTNHHNBTNNHNHNTNNTHNTNNNHBNTHNHHNNNHTBHNNNNNN
BHNNTNHNNHNTTNTNBTTHHTNHNNHNNHBNBHTTNHTNHTNNNNTHNTTBNHHTTBNNNNTNBNBBHBNBNHNHNBTNHTNNNNTNTBNTNTHHHTHN
NHNNNHNHNBTBHNNHNHTNNNNTNTHNHNBNHTTNBHTTNNHHNHNBNNHNTHBNTNBNHHNTNBTNTNHBNTHNTTNNBTNHBHBNHBNNNBHTNHTB
TNNHTNTBHTNBHTBNNNBNHNNNNNHHNHNNNHNNHHNNBBNHHTHNHBNNNNHHTNBTNNNTNNTNHHHBNHBNNNNTHNHNNNTBNTNNTNNTTNNH
NNNTNNTNNNBTNNBHNTTTNHNNNBHNHNNHHNTNNNHHHNNNHBNNNHTTBNNHHBHNNNBNNHHNNTTNNNTHHTHNTNBNTBNHNTNHHNNNTHNN
NNNBNHNHBNNNHTHNNBNNNNNHNHNTNNNTNNHHNNNHNNNNHHTNNTNHNNNNTTBNHHNTHNNHHTNNTNNHTTNNBTNTHNBNTHNNNTTTBNNN
HHHTHHTBTNHNTNBHNNHNNTHHNNNNNNBNTNHNTTHBNNNNNNNNNNBNTNNTNTNHNBTBBHTTTNHBHNTTHNNNBNTBNNNBNNNNNNNBBTNT
THNNNHHTHNNBTHNNNTNHTHNTBTNTNTTBHNNNNHHTHNHNNHNNTNNHHBNNTNTHNNNNBTTNNTNHHNHNNHNTNNNHHNHNTHNNBTTNNTBN
NNHNTNBNHHNNNNTNNNTTHHNNBBTNNHNNHHHTTHBNTNNHNHNNTBNNTNHBNHHTTNTNHBNBBHNNHBNNHNNNHHNNHNNBHNNNBTNNNNHN
NTNNNBNBNTTBNNNNNNHNNNHBBNHHBNNNNHTNHBHNHNNTHHNTNNBNBNNNNBTNNNHNHBTTNTNHNNHNNTNNBBNHNNNNNHTNHTNTNHTT
NNNTBNNNNNTTBNNNNHNNNNNTTHTNTHHNNNNNNNNNHTNTNHNTTNHBNNHNHTTHNHNHNHNTTNNTTNHTBBNHNNNNNNTHNTHNNBBNTHTH
THTNTHNNNNBHNNBBNHNNTBNBNNNNHNHTTNTNTNHNHTBNNNNNHNTBBNHNTNNNNTNNNHNNTTTNBNNNNNNNTHBNNNNNTTTNNTTNNTBT
NNBHNNNTTNTNHNNNTTNBHTHTNHTHNHHNNTTNHHNNNHHBNHTNHNTHHNTTNNNNNNNTHNTNTNTNTHNNTNHTNNTBBNNTNHHHBNTNNNBT
HHNNNNNHHNHNNHNNNHBHTHNNNNTHBHNNTHTBNBNNHNNNTNNTNNHBNHNNHNTHNNHNNNHNNNHNHTHTTNNBTTNBNTHHHHHNHHNNBNNH
TNTTBTTBNNNTHNNBHNHNNTNNBNNNHHNHTNTBBNHTNHTTHTNTHTHBNHNHNNNNBNHTNNTNNNNHNHNNNNNNHNTTNBNHNNNNBNTBNNNT
NTNTNNTNHNHBNNBTNNHTNHNBTNNHHTTNNNNHBNNNTTBHNBNHHNNNTTNHNNTNNNNTNTNNNHHTNTNTNNTNNHNNBHHNNHTNNBTNHTNT
NNBNBNHHBNNNTNNBTTBTHNTNTTNNTHBNNNNHNNNBNNTNNBNHNHHTTHNNHTHNHNBTNNNTHNTNNTNHHNNTTNTTNNTNNNTNHNNNNNNN
NNHNHTHTTTHTTHNHBHTNNTNTNNNNNNNTBHNNNTHNNHBHTTBNHHTNTBTTTHNNTNHNBBNHNNNNNNNNNNTHTHNNNNBNTHBNNNHNHHHN
NHTNNHNTHNTNBNNNHNTNHBNHTBTNNBNNNTTNNBNNNNNHNTHHBHNTNNHTNNTNNNHNNHTBTHBTNTNNHNTHTTNNTNTNTNNTHHNTTNNN
TNTHTBHNNNNNNNNTTNTNHNNNNHNHNNHBNNNBNHTHNHNNBNNTHNNNTTNHTHNNTTNNHNNHHNNNNNNBTNNHNBHNNTTNNNNNHNNBNHNT
HTTNNNNBHNNNNNNNNBNTNBBHBTNNHNNHNNTNNBNNNNHNTNTHNNNNNTHNNNBHNNTNNHNNNNNBNNHNNNNHNNNTTTNHTNNNNHNTTNHN
BBHBHTNNHHNTTNNNNNNHBBNNTNHHHHNNTNTNTTTNBBNTNTNNNTNTNTNTNNBNHNHTTTNTBNNNNTNNNTTBNNBNNNTNNNHNNNNTNTNT
NNTNNNNNNTTNNNNNHNNNTNTNHNHNNHTNNNNNHNBNHNNHHNNBNNHNNNNBNNNTNTHNTNNBHTBNNBTNTNNHHBNBBBTNHTTNBHHNTTNB
NHNTNNNNNNTHNNTNHNTNNNBHBTNNNNTNNHNNNTNTTTHTHTHTNTNBNTNBBHNHTHTHNTNNTNHNNHNNNTHNNNBNNBNNHBBHNBNHHBNB
THNTTNBNBHNNNBNTTTBNBHHNNTNNTNTHBNNNTNTBNHHTBNTBNNHHBNBNNHTNNNTNNNNNTNNNTNBNNNHBTNNHTTNTNBNNHNNNBNNN
NBNNNNTBTNNNHBHTTNNTHTNTNHNHTHNNTNNHTNTHHBNNHNNTHNNTNNHNNBHNTNHNHTNHNNNTTNBNBBNNNNNNTNHHHNTNNHNNNHNN
NBTHTNNNNNNHHHNNNBNNTNTTTBNNHNHHHNNNNBNNNTHNBHNBHHTHTNNNHTBHTNNHNTNTNHTNBNNBNNBNNNNNNNNNNBNNHTHNHHNN
NHTTHTTNHTNNHTNNNTTBNNNBNTTBNNTBNHNNTTNHNHTTNNNNNHNNTHBNBTNHNNNTNNHNBHNHBTTTNNNNTNNNTHTTTNTNNNTBNHHN
NNBTNNHHHBNBBNTTNHHNNNNNBHTNBTTTTBHTHNHBNHNHTHNNNTHNTHNNBHNNNNTNHHNNNNNNTTNHHNTHTHNBNHNTTBNNBNHNNNNN
NNNBNNNTNHBBNNNHNTNNHTTNTNNHNBNNNNHNNHTNBNNNNTTTHNTNTNTTHNBBNNNNNNHNNTNTNBTTTNNTBTHTNTTHNNNNBHNTTNBN
NTNHHBHBTNNTHTNHNHNNTTNNHNNTNHNNNHNHNTNBNHHNTHBBTBHTTTTNTNNHHTNTTNNTHNNNNNNBHNNNHHNNBNNTNTTHHHNNTHTB
TNNNNTNNNBTNNTBTHNNTNNHBHHNTNHHNBNNNTNTNNBTHBTNTNTTHHNNNTTNNNNNNHHNTNNNNHNNBNNNNTNNHNTNNHHHNNNNNNHHN
NNNHNNTNNNNNNHBNNTNNNTTHNNNNNTHNNNNNHHNHNNTTNNHNHTNNNBBNNTNTNNHTNTNNHBNNBNNTHNNNTTNTBTNTTNTNTTHNNNHN
NTHNTNHHNHNNTNHNNNNTNTNHTNTNHBNTHTNNNBNTNHNTNHTNBTNNTHTNNNTNHTNHNHNHTNHTTHNNNNNTTNNNNNHNHHNTNTNHBNNB
HNBHHNNTNNNTNNHNBHTHNNTNTNNTNTHNTNHBNNTNTNNTTTTNNNHNNNHHHNNNBNNNNNTNBNNTNTNNNHNNHHNNTBNNNNNNNTNHNTHB
NHNNHNHNHNHNHHHNNHHNNTHTBHNNNHTTNHNHNNHNHHNTTNNNNHTNNNHHTTHNHBTNNNBNNNNNNBBTNNHHTNNNNNHHNHNNHNTBBNNH
THNHNNBTHHHTNNNTNHTHNHNBHNNNNBNNTHTNTNNTNNHHTTTNTNNNHHTNNTNHTBNNTBNHTNNTNNNHBHNTNTTNNHTTNBHTHHBHTNNN
BHTHNHHNBHHNNNNTNHNNNNNTTTNNNNNTNTNTBNHNNNNTHTNTNTTNBTNNTBNBHNNBNTTBNNNHHNBTBHTHBNTNNNHNNNNHNTNTNNHT
TTNNNNNHBBNNTHNHBNNNHNBHNNNNNNNNNHNHHNNHHTNNNNNBNHBBNHTBTNHNBNNTHNNBHNTNTHHNHBTTTBHHNNTBNTBNTHTNNTNN
NTNHNHNTNNHNTNTTNHHTNHNTNTHNBNNTNNNNTNHHHNTTNNTHBTTNTHHNBTNBHNNTBNTTTNNHNNNNNNNHBNTTNTHNNBNNBHNNTHTN
NNNNNNHNNHTBNNBNNNNTNHNHTHTHTTHNHNBNBTBBNHHNHHNHNHNNTNNHTBHNHNNNNNTNNNNNNTTNHNBNNHNNNTNHNNBNNTNHTHNT
NNNNNNTNHTTNTNHTHNBTNNHHHTNTNNNNTTNNNNHHHBNHTTNNHNBBNNTNNTNNBHBNBHBTTTNNNTNNTNHHTHBNNBNNNNNNTTNNNHTT
HHTNNHNNHNNNNNNNNNNBTNNTHHNNTBHNTBNNNNHNNNBTNBNNTTHNHNTBBHBHHHNBTTHTTTNTTNTHBTTBTNNHHNHBNNNBNTNNNTTH
BHNBNNTTHNTTHHNNBNNNNNNHHNTHNNTTNTTNNHBNBHHHTNTNNHTTHBTHHNHHTNTNBBNBNNHHNTNHNNTNBTHTNNNBHNNHNHHNHNNT
NNTNHNNBBHNNTHTNNNNHTNHBNHNHNHHNNNTHTNHHHNNTHTHBNBHBNNNHBNTTHHNNTHNTNHNBHHHBHTTHNNNHNTNNTHNNNHNNNNNN
NTNHNNNHNNNNNNNNNHNBHNTHNNNNHNNNHBNHBNNHNNBNNNNHBNTBNNTTTNNNTNNTNNNNNNHNNNNBBNNTNBTHNNNHNNNNBTNNTHHH
TNNBHNNNTTHTNTNTNTTHTHBHBBTTNTHNTHHTTTHNBHTNBTNHNTNNNNNNNNHTNBNNNNBNNHTHBNNNNHNNBNHHNTTNBNNNNBBHTNTN
NNNHTNNNBTHNTTHNNNNBHBTTHNNNBNTHNBNTHHNNNTNNNHHNHNNNHNNTNNHNHNNHHHHTNBHTTTNTTNTNTBNNNNBNHTHNNNHNTHHN
NNTNHTNNHNTNNNNNNTNNNBNTHBTHTBNNHBNNNTNTHHTHNTNNNNHHHHNTBNHHNBHNNNNTNNNNNHTTNHNNTNNHTNNTNHNHNNTNNBNT
TNHNTNNNTNNNNNTNNHNTBNBHNHTNNHNNNNNNTBNNHTNHNNTNNNHHNNNNHHNTNTNNTHNNHNNNHTBNNNNBNNNNTNTHTNNNHNBHTTBN
TBTTNNTNHNNNNTNHHNNBNNHTNNNBHHHNNBHBHNHTNBNHNTHNNNTTNTTNNNNNNNHHHNTNHTNBTTNHBNBHHNNTHTNNHTBNNNNTNBNN
NNNHTHHBNHNBBNHNTHTNHNBNNTNHNTTTNTNNNNNNTNTNNNHNTNBHTBNBTNNTTHNTNTHNTNBBHTHTNHNHNNTNNTTNNTNNNNNNBNTH
NBHNNNHHNNBTNNTNNNNNNHNNTBBNNHTNHNNHBHBHNTNNNTTTTTNNTTNNHNNNBNNNNNNNNHNNBNBNNBTBNBNHTNHNNNHTHTTNNNBB
BTNHNTTNHNNNTNNNNHNNNNBTNBHNNTNNHTTNTBNHTNNNNHNTNNBHHNNTNBNNTHNTNNHTBBTNTHNHNNBHNTHNNTBNNNHNNBHBNTTB
HHTHBHNNNNTHNHNHNHHHTHBHHNHNTNBNNNNNHNNNNNNTHNHHHHNNNHTHTTHNNNBNNBTBHNNNNNNTHBNNNTTNNNNNTNTBHNHNBBHN
