(27, 1)
NNNBTNTTTTHNHBTBTHHHNNBNHHNTNNTNTNBHBTNTNTNBHNTNNHNNNTBNHNHNNTTTTHNBTTNTNNNHNNBTBTNNTHBHNNHNNHNHNNBB
TTNNBNTBHNNHNHNTTTTTHNBHNNHTTNNNNHNTBNNHTNNHHNHNHNNNHHNNHNHTHHNNHHNHNNNBNTHTTNNBHNNNNTNBNHTNHNNNNHBT
NTHNTHNTHHTTNNNHHNNTHHTBTNNNNNNTHBNNBNNNHNNNTHNTTTHHTHHHHNNNTTNTNHHNHNNHHHNNTTTTNNBNNHNNNNTNTTHNNTNN
NTNNNTNNNTNBHNHBNNHHTBNNNBNHHTTHNNTNHHNNNNTHNHNNNHNHNTNBTNNTTHNHTNHNHHNNBNNNNHNNNBTNNNBNNHTNNNNTNNHT
HNNNNNTHBNBTNNNHNTHNBBHNNHNNTTNHHBHNNHNNNNNTBTBNNHNTNNNNNNNNNNNBNBNNBNTHNNHNNNNTNNNNHNTTNHNTHNNTHNTT
TNBNNHHBNHNBNNNHNHNNNTHBTTNNNBNHHTNNNBNNNNTNTNBNNNNNNBHBNNNNNBHNNNNTNNBNNNHBNBHNNNNNNTNNNNBNNHNTNHNB
HNNHNTBNBNTNTBNNHTTNTTHNNHBNNNNNHHNHNBTHNNNHHHBBNBHNNNNHNTNNNNNNNTTNBTNHTTNTTTHBHNTTNBNTHNNNNNHNNBTN
NNBNHNTHHNHNBHBNNHBHHNBNTNTHTHBNNHNNTBBBTHNNHNHNNNNNTHNNNNNBBNNTNNNTNNNHHHTNNNNBBHNNNNHNNBBNHBTNHNBT
HTHTNBTTTNTNNNNNTNNNHHTNHNNHTTNTHBNNBTBBBHNNBNNNNBTNHNNNNNNNBNNNNNBNHTNHBHTNNTNTHNNNNNHTNHNNTTBNNNHN
NNNNNNTNNHNNNNHNNNBNNNHHBNTNNTHNNTNNNBNNNNNNNNNNTNHHNTHNHTTTNBNNNNNNNNTHNTTNTNTTHNNNTHNTHNNNNNNTTBNN
TTTNHNNNNNNHNHNBNTNHTBNNNTBHTNNBNNTHNTNNNTHNBHTBNHHTNTTHNBHNHBNHNNTBNNTBBTHNHBNHHNNNNHTNNNHNTNNTTTNH
TTNHTTNTNNNHNTBNNHNNHNTNNTHNNNBNNHNTNBNHTNNNHNHNTTNTTBNNNNHNNTBNTNTNNBNNHTNNHHTTBNNBBNNNNHNTNHNNNHBN
NHNNBTNNHHNHNNTNNNTNNNNHNHTNNNBTNNNTBBNNBNHNNNNHNNTNNNNHTNNNHNNTNNTTNNNTNNNNTHBNHNTNTHNNTNNHHHTHHNHN
HNNNTTTHNNHNNTNNNHTHHNNTNNNNNHNTNTNNNTNHNNNNHNNTNHHNNBNTHBNNBTTBNNNNNNNNTNBHHNHHHBNNHTNBNHNNBTNTNHTH
NTBNNHNTNHBNNNHNNNTNNBBHHNBNHBNNHHNTNTTNNNHTBNNNNNNNNTNNHTNNNHNTNTTNHNHNHBTHHTNNBNNTNBNNNNHTHTNNHBHT
NNTNNNTNBNHBBNNHHNNTTTBHNNNBTHNNNNTNHBTNHBBTNTNNTTNHNHNTNTTBNNNTHHNTNNTBNNNNNHHHHNBNNHNTHNNTBTNNHHHN
NTNNNBNTNTBBHNBNNNTNHHHHHNTTHBNTHNTBNNNHNNNNTNNNTNNBTNHHNNHNNHNNTNNNNTHTNTNBBNTNBBTNTHNNNNNTNNHTNNNN
NNNNBNNBNNTBNTNBNTHNHNHHNNTTNNNNNHNHHTNTNNNNNNNBNHNHNNBTNNNBNNHBNNTBTNNNNHNNHHBBTHNNNNTTTNNNNNNNHTNH
TTHNNTNTBBNHTHTTBNNHNTBHHNNNNHBNBHNNNTHTNTNHNNNNNNNHNNNNHNNHBNTBNTNTTNHTNHBBNNTNHNNNTNTNHTTHHHNHNNHT
HTTTBTTTBNBNNBTNNNTNNNNNNTHTNNTBNNNTNTTNNNTHNHNTNHHTNNBTNTNBNNNTTBBHBHHNTNHTNHBNNBNNHNHNTNNNHNTNNNTN
HBNHHTNTHHTNBNNTTNNTHNHTNNNNHNTNNNNNNHHNBNTTBTHNHNNTHTNTNBTNNTNNNNNNNHTNTBNNNBNTNTNHNHHHHTTNTNTHNNTT
NHNNTNNNHNNTNNNNBNNHBNHNNTNNBNNTNNNTHTTTTTNTHNHNHHNHHBBBNNNHNTNNHNTHBTTTHBNNNBNNTHNHNTNTNNHBHTTNNTHT
HBNHHNHHTHNNNTNNBBHHHBNNBBHHBTTTNTHBNNNNTNTNNNTNHNNNTHNNNBTNTNNHHTTNNNTNNNBNBNHNNNNBNNTNHTBNHHNNNTHN
HHNNNNNHNHBNHHTBTNNNTHBNNNHNTTNNTNTTTNHTTNNNNNTTHBHTHTNNHHHHHHNNNHNHNNTNNHNTBNHBNNNNTTHNBHNHTBTBTNHN
THHTNNNBNNHHHNNNNNNNNNNNTTNHNNTBNNNHHHNHBNNHTNNTNHHTNTNTTNNHNNNNHNNTTNNBNTNNHTNNTNTNTNNNTTBNHHHNHHNB
TNNBHNNNNTHHTNNNNNNNBHNNHTNNBNNHNTHHNTNHHNHBNNNNNNNNNNBTNTNHTNBBNNNNHBHNTHTHHBBNNTBBNHNNTHNTHHNHNNNB
HTNNTTNNNNBTHNHNHHBNNBNTHNHNTNNHBTBNHTNTNBTBNTNNTTTHHHHHHHTNTNNTNNTTNHHNTTNHNNNNNNNNNNNNNHHNNBNTHNTN
TNNNTNNTNNTNNNTBBHNHHNTNNNTNBTTTTNHTHHNNTHNHNHNTNHNHTBBNNNTBNNHHBHNNBBNNNHNNNHNTNTTBTHNHNNNNNNNHNHNB
HNNHNHHNNNHTTTNNBHHNNHNNNNNTNNBNHNNHNNNHNTNNHNNNNNTHBNBTNNNNNNNBTTNHHHTTNNTNHTTHNNHTNNNNNBHHNHNNHTHN
TNNNNHTNNHHNBTHNNTHNNHTBBTNBNNNNHTNNNNNBTNHNNHNTNNNNHHHHTNNNNNNHHNNBNNNHNNNBHTNHBBTNTBNNTNNBTNNTNNHB
HNHNNHTNBTHHHBHNHNHHHNNHTHTTHNNHHHNHBNTTHBTTHNHTHNNBNBBHNBNHNNBTTHNNHNBTHNHNNHNHNNNHNTHTNNTTTNHHHNTN
NBNNHBNNNNNHBTNNTTHNHNTNNNNHNBHTBTNNBNNBTHHNHNNNNNNNTNTNHTHTNNHNNNBHHHBTNNNHHNHNNHHBHNBHNBNNNNTNHNHT
NNBHTNBNTHHNNHNHNNNNBNHNNNTTBNHNTHBTNNNTNHNTNBNTTHNNHHTNHTNNNNTHNNNNBNHNBNNHBNNNNTNNNNTBTHHNHTHTHNBN
HNNHNTTTTTNHHNTNNHNHHTHNTHNHTNNTTNNHBNTNNNTNHNHNNNBNNHHTTNTTBHNHNNTBNNTTTNBBNNTNBNTTTTNBHHNHNNTNNHNN
THBTHHNNNNHNNNHTNBNNNBNNTNHBNHNNTBNNNHNHTTNNNHTHNHNNNTNNTTTTNNTNNNNHTNNTHHBNNHNNHNNNHNNTHNNHHTHNNNHN
NHTHTNNNNTNNTNHNNHTHTTHTNNNHNHHTNBHNNTTHNTTNTNBTBNTNNNNNNNNHHNTTHTBNHNNTNTNHTHHTTNTHTBNNTHNBBNBTTHHN
THTTBHTNNTNNHTNHNHNNHNBTTTNNNNNBTTNHNNHNHNHHNNNNNNNNHNNBHTHNNBHNBTHTBNTTHNNNNHHBNTTNTNHHHBNHNBBHTBNN
HHNHHHHTNNNTHHHTNTTNTNNNNNHNHTTNTNTHNTNNHHNNNNHHNTNBNNNNTNNHHNTTNHTNBTNBNHNNHNNNNNNNTBHHHTHHTNHNBHNN
NNNBNNNNNTTBTHTBNNNNNNNHHTNNNTHNNNTNNTHNBTNBNHNNNNNNTNNNNNNHHNHBNHNTHTHHTNNNHTBNHNNNNNHHHTNNNNHNNNNT
THNNNNHBBBNTBNTNBNNNNHNTNBHHNHNNNNNNHNTNHNHTBBBNNNNHTBNNNTNNBHTNTNHNBNNNNNNHBNNNHHTTTTHBNNHTNBNNTNNH
HNNHHTNNTBTTTTTNNNNHNTNTNNNNBTHHTNNNHTNHNNHTNNHHTTNNBHHNHNTTHHHHHTNNNBHBTTNHNHNNNBHTNTNNNTHNTTBNHNTN
THBTNNHNBTNHNHNTNBNNNNNNNTHHNBNNNBNTHHNHNNNNHNNTNNBBHNHHNNBNNTHTHBTHNNNHNTNHHTNHNHNHNNTNNNNHHNNHHTNH
NNNTBHNNTBNNNNNNNTBNNNHHNBNNNNBNNTTNNNNHTTBNNBHHBNHNHHNNBNTHNTTNNNTNNTNHHNBHNBNNNHHNTBHNNNTBNNNHTNNT
HHNNHNNNBHNNBNNBTTBBTNNTHTNNBNTTHTTNNNHBNTNNNTNTBHNBHTTHNHNNBBHNNBTNNBNBNHTNTNHHHNNNHTHBNNNTNHTTNNTN
TNNHNNHNTNBTBHBNHNNTNNNNNNNNNBHNHHNNTNNNNNNNTNNHTTNNNTNTNNNNTTTNNNHTNNTBNNBNBHBNNNNTTBNTTNNNNHTNBHTT
NNTHBNNHTNHNBNNHBHNTNHNHNTNTTNNNNNNNNBNNNNBBBNTTTHHTNHNNNTNTNNNHNTHTBBTNNNNNBNTNNHHNBNBNNHNNHNBHTNHN
THHNHTNHBNNNHNHTNBNBHHNNNTTHNTNNTNNNTTTNNNTHTTTHTNHHHNNTBNNTBTNNNNNHNHTNTTHNNNTNNNNTNHNNBTTTTBHTNHHN
NNHNHTNBNNNTTNHBNNHHHNNNNTNHNHNNTNBNNNHNNNNTTNHNNHNNTHNBNHNNNNNTNHTNNBHHTNBHHHBHNHNNTBHTNNTNTTNNTHNN
TNNHBNHHNNNNNHNTNTNNBHHNTNNTHHNHNNNNBHNTNTNNNTHTNNNNNNHHHNNBNBHNNTBTBHBHTNNNTBNNNNNHTHNNNHHNTNNTHTBN
THTNNHBTBTHNNNNNNNNHTNNTHHTTHTNTHNTHHTNHTTHNNNNNHNTHNTNNNNNNNHNBTBTNHTNTNTNTHHTNNHNHNNHNTHHHNHNNHTHN
NTNNNHBBNNHNNHNNNNBNBTHBNNTNNHTNBNNNNHNNBHHTNNNNNNNTHHNNHBNNNNHNTHNNNBTTBHNHBTBTTTNHNTNHBHHNNNNNTTNN
NNNTTTTTNBNNNHNNNNNNHNHNNNTHNNNHTTNHNNNNHNNTNNNHNHNNBNBNNTNTHNTNTNNNTNNBTNNNBNNHNTNHNTNNNTTHNNNNNNNH
NTNNHBNHNTNTNNNTNTTTHTNNNNHNNNBHNNNNNHNBTHHNTHHNHNHTNNHBTNNBNNNNHNBNNTTNNHTNNNTHBTHTNTHHNNNTHNNHHNHT
HBBBTBTNNTNBNTBNTNBTNTTTNNTTTNHNNHHHNBNTHHHHNNNTNNNHNNTHTTBHTBTBHNTNNBNHNHTTTTTBNNBNNNHNTTNHTNTNHNNT
BNNBTTTNNNNTNTNHNNHNNTHHBNNNTNHNHNNNTTNTNTHTHNBTHBNNTNHNNNNNNNNNNTTNHTNNNTNNNTTNBNHNTNHNNNNHBHNHNNNT
NNNNNNNHNTNHTNNTHNTTNBTNTHNNNHTHTHNBNNTHTNNTBNTNNNHNNNNNNHNNNHNNBTTNHNTHNNNNNNNNHNNTTHBTTNTHHHNNHHNN
THTNBTNHHNBNNNTTBNTNTNHTHNTNNNBTNHTNHHBNNBNHTTNTNNHHNBHHNNNNNNHNTTBNTTTNNNNNNTHTNNTBTNHNBHHHTTTTHHTN
TTTNNNNHNHNTNTTTHHBNTHNHBHNTHNNTTNNHTBHNNTNBNBNNTNNNNNTBTNTTNHNNNTNNNHHNNNBNBNNNBHNNNTNTTNTHNHNNNNNN
NHBNTNNTNNNNNNNTNTNHBHNTNTNHTHBHBTNBHHHBBTNNNNNTTHNNNBNTTTTTNNNTBBTNNTNHNNBTHHTBTTTNTNNTNHTNTNBHTTHN
NNNBNTTBHTBNNHNBHHTHNNNTNNHHTTNTNTBNBHTNHNNNNTNNNHNHNTHNTNBHNNNBHNNNNNTHNNNNNTNNNNNNNNHTNTNNBTNNNHNN
NNTNHNNNTNHNTHTTTNNBHHNBHTNHTTNNTNTHHNHNNNNTTTNHNNNNHBNNBHHNNHTTTHNHNTNTNNNHNBHNBTTHHTBHNNNTNNNTBNHT
NHNNNTNHNNTNNBNTHNBNNNTTTBHNNBNBTNNBHBNNTNNNHNNNNNNHBNNTNNHHNNHHNNHNBNBNNTNTNHHNBNNNNNNTHNNTBHNBHNNN
BBTTBNNNNBNBNTBNNTHNTTNBNNHNHNHBNBTTNNTNHNTNHNHNBNTNHHNBBHNNTNNTBBHHTBNBBNNHBBNNNBTBTNTNTNNHTNNBNTTT
NBHNNNNTNNTTNNNTHNNTHHNTTNNNTNHNNBTHBTHNHTBNBNBNBNBNHHNTNTTHBBTNBTNNHNHNTHHNHNNNTHNTNNTHNNNTNNTTNNTN
TTHBNBNNNNTHHBNHHTHNNHNNTBNNHHHBTHHNTHNNNHHHTNNNBNNNNTHNHTTTNNNTHNNHHNNHTTHBNHNNNNNNHNNNNNNTTNNHBTBT
NNHNNBNBTHNNNTNNHNHTHTHNNTBNNNNTBTNNHBBHNHNTHNNNHNNHHHNNNNHTBNNTNNNNBTTTNBNNTNTTHNNBHNHBNHNTHNNNHTHN
THTTTBNHHTHTNNNHNTNHNNNHNHNTNNHNNNNNHTNTBHNTNBHHHNNNNNNHTBNHNNTNTNTHNNNHTTTNHHHBHNHNNNNHNNNNHNNTNNHB
TNHNHHNHNNNNNHBBNBTHNTTNHNNNNNTNTTNHNHNHNNHTTNBNNNNTTHNHHNNNHTBNHNHTTHNNNHNBNNTTHNNTNHTHTNTNNBNNNNNN
THNTNBHNNNNBNHHNBBNTTNNNTTTTBHBTNNNHNHNNNNHNNNHTTNNNHNHNNTHHTNBNHNNNTNNNNHNHNNBNNNTNBTTNNHHTNTHNNNBN
NHNNBTBNTNNNNTNTNNHHNBNHNNBNHTNHNTTNNNNNTNHBBNNHBNTNNBNTNNNTTHTNHTHHNHHNNNNTNNHTTHTNTNTHNTNNBNBNNHTH
NNNNHNHTNNTNNHNTTNNBTHHBNHBNNNNNHTHHNNNTHNNTNNHHNBNNTNBNNNHNBBTHNNHNNTTHNTHNNHTTNHNNHNTNNNTNNTHTBHHN
BNHNTNTNTNHNHHHBBNNTNNBNNNNBNNTNNNTNNNBNNNHTNHNHNNTTNNNBNNBNBNTTNTTNNTTTHBNTTNTBNNBTTNNHBTNNNNTBNTNH
NTHNNHTHTNNNTBBHNNNNTNTTHTNHHTNTHTBNNNNTNNNHBBHNHNTNNTNHTTNTHTNNBHNNNNBTTHNNNNBNHTTNHNNBBHNNTNNNNNNN
TTNHBNTNHNHHNNNHNTTNNTHNHNBHNNNNNNNNNNNTNNBNTNTHTNBNTNNTHHNTHNHNNHNTNNNHHHNBHNNNHHTTNHNNHNTNNNNTNHHT
THNNNNHHBTBNTNNNHTTHTNHNHNTTBNNTNTNTNNNNNTNTNBNTHHNNNNNHNHTHTNBNTNNNNTTNNNHHHHNNHNNNNBHNBHNTNTNNNNNN
BBHTBNHHNHHBBHBNHNNHHNHNHNTNNHTHNHNHBNHNTNNTTTNHNBTBTNNHTHNHNNNNNNTTNTNHNNHNNTNTNNNTNTNTTNNTTNNNNTTN
NTNNNHHTNNNNNNNNHNNHHNHNNNNBBHTNNNNNTTNHTNNNNNBHTTTNNNHTNTTNBNNTBHNHNTNHNTTNTTHHNHHTBNNHNNTNNNHNTTNN
BNHNNNNNNNNTNNTBHTHBNBHNNHNHHNNNNNHHNTHBTNTNNTNHBNTTTNHTBNNHNBTNNNNHNHNNHBNHHBNNBHNTHNHNNNHNNHNBTNNT
TNBNHNBHNNHHNTNNNNHHHBHNNHHHNTTHTNHNNBNHBNNNNBNNHHHTHNNTNNHTNNNNBHTHHNNTBNTHNNHNBNHNTNTNBHNHNNNHTNTN
HHNNNHNNHNNNNHNTHNNNBNTNTTNBTTHBTHNHTBBTNTTNNTNBTNNTTBNNNNHNNNNTHNNHBNTHHTTHHBHTHHTBHBTNNNNTHNNNNHNN
NBNTTTBNBHNTNTTNHNHNBTTTBNNHHNHNTHNNBTHNHHNNHHHTNNNTHNTBNNHHNHBTHNNNNHNNNTHTNNTNNNBBHNNNNBHNNNNNNTTH
NNTNTNBNNTNBNNHHHHHHBNBNNNNTHTNNNNNHTNBNHHNNNNNHBNTTNTTBTNNNNTNNNHNNNTNBNTNNNTTNTHTHHBBHHNNHBNNTNBNH
BNNNHNNBNTNBNNTNTHHNNNTBNHNNNBNNNNHNHBHNNNNTHNHNNBHBTTNNNTBBNNNNNNNNNNHHHNNNTHHHNNNNHHTNNNNBBNNNHNTH
TBTNNNBNNNNTTTTHBNTNTTTNNNHTHBTNHHBNTTNHNBNNNNNNTHHNHHHTNTHNNHTBNNBTHNTNHNNHNNNBNNNNTNNHTTTTBNHHTNHB
NBBNNNTHNBNBNNNNBNHNNTBHNBNNHNNBTHNNTHTNBNTNNTBNBHNNNNHHNNNBTHTNHNHHNNHHTNBNTHHTTNHBNNNNHNHNNNNNTTNT
NTHNTHHNNNHNBNTNHBNNTHNHHNTNTNNNTNBTHNBNNBNTHTTNNNTNNTHNBNNTNHHNTNTBNNNNBTTHNNNNNNNBHHTNHHNTHNNNNNNN
NNTHNHNTNNNTNTNNNNHHNNHNNNTNHNBNNNNNBTNTBBTNNNNBNBBNHNTHNNHHHHNBTNTNTNNHTNHTBTHHNHHTHNBTBNTNNNNNTTNN
NTNTHTNNNNHNNHHNNTHHHNTNNHNHNTNBTNNNNTNNNNNHNTTHNNNNTBNTNHNNHHNNTHBTTNBNNNHNNBNTHHTNNNNNTNNBNTTBNNNB
TNHHHNNHNTNNHTTHNNNTHHNNBTNNNNNTNNNNHBNTTBBBHBHBHTBNTNNTHNNNNHNBTBNNNHNHNHNBNNBNNTNNNTTNBNNHNHNTHHNN
NNNBBHTNNHBNHTTTNTNTNTBNNNTBNBNNNNHHTHHNHNNTNTNNNNHNNTNNNTNNNTHNNNNTNTNNNNNNNNNNTNNHNNBNNNNBTHHTHTNT
THBNNTBTNHTNBNTTNNNNTTTNTBNNHNNHTNNNHNNNTTNTNNNNNBNNTTNNNNNTNTHNHBTNHNNHTNHNBBNHNTTHTTNNTNNNBHTNNHNB
NNTNNHBNBHHHHNNNNNNNNTTTHNHNNNNNHHBNNHNTHNNBTNNNHHNNNTHNTNBNBNHNTNNTNNTNTNNNTBBNBNNNTNBNNTBBNNTBHTHH
BTNTNHNTTNNHTNNNTNHHTBNNBNBTNNHNNTBHHHNTNNHHHBNTBNHNTHBNNNNNNHNNBTHNNTNNNNNBNTNBNTTNNHHNHTHTTHNNHNHN
NHNNTNHTHNHNTNNNTNBHBHNHHTNNTNBNNTNNNBNNHNHTNNNTTNNNNBNNNNHTNTNHTNNNNNNNHNNBNNNNNHTBTNNTNBNTBNTNNTNN
TTBTHNNTTNTTTNTNNTHNNTHNTNBNNNBBNNNNNHHTNNTBHNNNTHNTTTNNBHTTNNNNNNHNHHHHTBBNNHNTHNHNBNNNHTNNNNNNNHTB
NBNNNNTTNNTBHTBBTHBNTBTNNNNHNNHTNTNTNTNNNNTNTNNTNNHNNBTNNNNNHNNNNBTNBHNTNNNHBHNHNNNBNTNNTNTHNHNHTNTN
TNBNBNNHHNNNNNHNNNNBBNHNNNNNNNHNHNNHNTNNTNNNBTHNNBNHNNHNNNTBHNHNHTNTNNTHTNHNHTTHNNNNNNHTTNTNTNHNHHNB
TNHTNBTNBHNHNNBHNBBHNNNHNNTTNTTHNBNBNBTNBNHHHBNNTNNNTHNNNBTNNNTTTHHBNNNBNTNNNHHNNBTHNNNNHNNNNNNNTNTN
NTNBNNNTNNHBNNHHNHNTNHNTNNNHBNNHNNTNHTTHNNHNTHHNTNNNHTTHBHTHBNBNBNNNNHTNNHNNTNNNTTNNBNHNNTNNNBNHHBBH
NNTTNTNNTNHHNNHNBNNBBNNNNBNTTHTTHNTNNNNNNTTNNTNNNNNNHNNBNBBNNNHBHNBNNHNHHHTNNNNNHNTNNNNNNNNTNNTNHNBH
