(99, 67)
TNNHBNNNNNNTNNNNNHNNTHNHTNHNTNHBTNNTTBNNHNNNNNBTHNNNTNBNTHNTNNHTNNTNNNNNHNNNNHHNBNNHBNNNTTNNHTTTNTNT
BNHHHNHNTHNTBTNHTNNBBNHNNNNNNNNNHBHHHNTNTNNBBNTBTNTNNTNNBTHNHNNNNTHNHHNNTHHHNHTTNNNHNHHTNNNNHNTHNTHB
NHTHTNNNTBNNNNNNTTNNHNNHTNNNHHHNHHNBNHNNNNNNNHHHNNBHNTTNHNTTBNHBNNNHHNNTTTNBNTNNHTHNTBNNBHNHHNNNHNNT
NNHNNNHBNNBNBTNNNNTNNNBNTNTNNNNHHNNNTNNNBNHNHNNNNTTNNNTNHHTBHNNNHBHHBNNHTHHNBNNNNTNHTNNNHNHTHHHHNNNT
HNTHNNNTBNTTHNNNHTTNNBTTNTBHTNNNNHTTNHNNNNNHHNNNNHNNNNNNNNBHTTTHNBNNNNTTNNBNBHNTHNTBNNNTNNHTTTNHTNHH
NNNTNNHNNNNNNNNNNHNTNHHNHHHTNBNNNNNNNBNTHTHHHBNTTNHNNNHHTTHNTNNNTNTNHNNNNNBHNBNNHBNNTBNBNTHTNBNNBNNT
HBHHNNTBNBHBTNHHHHHTHHNNNBNTNTNNNNTHHHNNHTNNBNHHTNTHHTNTNHNBNHNNBNNNHBNNNNNNHTNNNTNBBTHNTNTNNNNNNNTT
BBNNHTNTTHNNNHNTHTHHNNTHNHNNTNHHHNNBNHTTNHNNNTNNHHHTBTHHTHTBNNNHHTBNNHNNHNNTTNBBHNNNBTTBNNHHTHNNHNHT
NTNNTHNHNBNNNNNNNHTNNHTNHTNNTNNNNNNHTTBNBTNNTHNHTHNBNBNNHNHNTNNHTNTNHNHBNTNNTNBHNHHTNTNNNBBHTHBNNNHN
NTNNNHNHBNHNHTNNNHNNNHTHNHHNNBNTNNNNTNNNHTTHNNNHBNHNHTBNNTNNNNNNTNBHNNNNHTHBNNHNHBTNHHNNNNHNNTHTBNTN
HNNTNNNNNNNNHBNHHNTNNNHNNTBTNNNTTTBHTNNNTTNHNNNHNNTTNNNNTNNNHHTNNTHNBNNBNNNNTBHTNTTNHNTBTNNHTNNHNNNN
TNNHBNHHNHTNNTHTTBNHBNNNNHBNBNNTNNNHTHNHNHNHHNNNNNTNNNNBNBBBNHNNNNNHHNNNBNNNHHHNHTNNNNNNNNTBNNNHNBNT
NHHTBNHNBNNNNBNNTHBNNTHTBNNNNHHNTTHNBNNNTNNHNTTNTTNNNTNNNNBTNTNHHNNHNNTNNHHNHHNHNHTBNNTNHTNBBTHTHHNT
NHNNHNNNNNNTHHNNTNNTNTHHNHTBNBNTNNHHTNNHHNNBHNNHHHNNNNHTNNHNNTHBNBBHTTNNNHHNNNNNBHNTNNNNTNTNHNNNHHTN
NHNTNNNTBNHHHBTTNNBTTTNNNNNHTNBHTNNNNNNHNNNTNNNTHNTNNTHNTNTNHBNNHNNNNNNTTTNNNBNNNBNNTNTNBNHNNNTHBNNN
NNNTNHHNHNTNTNNBNHNNTHNNNHNBTHNTTNNTNNNTNNNNNHNHNBTBNNNHNTTTNNHNNNTNBBNBNTNTNHNNTTTHTNNBNTNNNNNNNNHH
NHNNNNNNNNNNHNNHNHNBTTBHNNNHTBNBTNNNNTHNNBHNNNNBNNHHTNNHHHHNNNTNNNNHTNTBBHTNBBNNNNNNHNNNBNTNNNNNHTBN
BNHNNBNTTHTNHTTHNHNBTTTTNTNNNNNHNNTTNNNNBBNNTNTTTBHTNNHNHBHNNNNNHNNHNHBHHTHNNTNNHTHNHNHTNNNNNBTTBNNT
BNNHNNNNBNNBNHNBHNHNNNHNNNBTHNBNTBTTHBTNBTNNNTTHHNNHHNTTNNNTNNTNNNNNTNNNHBBHNNNNNTTNNHNNNBTNNNBTBTNH
TNHNTNNHHNNNNNNNNTNNTNNTNNNTHNHHNNBNNNNHNTNTHNNNBTTHNNBHNBTHTHNTHNNNNHNNNTNBTNTNTNHTBNNNNTNHNHHBNNNT
HNNNNTNNNNTNNNTNTHNNHNHNNBHNBNNHHNNTTBNBTHTNNNNNNNTNTHHNHTHNNHNNNNNTNNBHTHHNNNHBNHNNNHHTHNHNBNNNBHHN
BBTNNBNHNHNNNTHNHNHNNHHNTNHNNHNNHTHTNHHHHTHNNNNNTHTTTNNNBTTHTHNNBNTNNNNNNTHNHHNBTHNTHHNNNNHHHHNBBNNB
TNNHHNHTTNHTTHHTTHTNBTBNTNNNTNNTHNTHNTNHNTNBNTNNNHHNNNNNHNNTNNBBHHNTNNTNBNNHBNNNTHBNNHNNHNNNNHNNHNBH
HNHHNNHTNNNNNHNNBNTNTHNTNTTNNNNNNTNNNTTNNHNNTHTTBHTNHBHNNNNHHBNNHNBHNBNNNTHNBNTNNNBTTHHHNNNNHBHBTNBN
HHNBNNNNHHNTTNTHTNNNNNHTNNTNNNNBTNBNHHNHNBTBNBHNNTNNHTHHNHHNNTBHHNNHTNTHTNHNNNNTNHNHNHHNNNTNNNNNNNNN
HHNNTNNTNNNBNTNNHNNNTNTHNNTTHHTNTNTNBHNHBTTTHNHNNNTNNNNBHNHHHHBHHNTTTNBNTNBBNBTHNHNHHBBTNTNNTBTNTNNH
BNNHNNNNTNHNNNHNTNTNBNTTTNHTNNTNNNHNNNNNNHTHHNNHHHNNNHHTNNTTNHBTHNNBNNTNNBNNTNNNNNNNBTTNTNNNNTNTBNNN
TNNHNNHTTNNBNNTNHHTNBTBTTNNHNBNTTNNNNHTNTHBTBTNHHNNNNNNBHTNBNTBHTTNNNNNNTNNNTNNNNTBNBNHTNHNHHNNNNTNB
NNTNHTNNTNNNNNNNBHTHTHTTNNBBTNTNHNTHBTNNHNBTBTNHBTNNNNBBNNNTTTNNBTBNTBNHTBNNHTNHNNHNTNNNTNNHHHNHNBBN
NHNNNHNNTNHNTTNTNNNTBHNTNHHHHTHNHTHNNBTTNNTTNNNTNNNNNHNBHBNTTNNNTHNHHTNNNNTNNNNTNBNHTNHHHTHNBBTHNBNN
NNTBNTHBNBHNNNNTHNTTNNHNNHNBHNNNTNHNTNTNBNNNBTNNTBNNTNNTTHHTNTNNHNHTBHNNTTNNBNNNNNNNNHBNNBHNNNBNBHTH
HBNBNHHNHNNNTNTTNTHTNHNTHNNNNNTNHHBNNHBHNTHNNNTTNNTNNNNTNNNNNNNNBNBBHNHHNBTTNTNNNNTHTNNNNNNNTTNTNTBB
BTNHHNNBNTNNNHNNHBHHHNNTNBHNTNNTHNHTTTHHTNNTBBNNTTNNHHTBNNTNBNNNTBBNNNHHHNNNHNNTHNNTNTNNTNTNTHNNHHBB
NTNHBTNNTTNNNNHNTNBTNTNHNNNHTHNNBTNTHHHNBBNTNNHNNTNNHTNNHNHTTNHNNBTNTNNHHNNNTHBHNHTHNNNTHNNNNHNTBNBN
BTHBNHNNNHTNNHBHTHHNTTNHTHNTTNNTTTBBBBNNTTNNNNNTNHNNBHTNNNTHNNNNHHBBBBBNNBTNNHNNNNHTBNTNTTTHNTHNNNHN
HTHNTTHNNNNTHNNHNNTNNNNNBNNNNTBBNBNBNHTNNHNNNTBNTNNNTHNTHTNNHTHTNHHNNHNNTHTHNBNNHTHTNHNNHNNNTNTNTNNH
NHNNNNNNTHNNTNNNTNTNHBNTHNNNNBBBNNNHBNNTNNTNHHNHTBTNTNHBTNHHNNHTNNHTHTNTNNHNNNNNNHNNHNNTTNNNTBTNNNBH
HNNNHBNNHTBTNTBBBNNTNTHNNHHTTTNNNTNHTNTNNNNTBNNNNTTHTBTNNNHHNNNTBNNNNHNHHNTNNNNBBHNHNBHNNNHNHTHTNNNN
NNNNNTNNNHTNNHNBBHHTNNHNNNTHNNNNTNNNNNNHNNBTBHNHHHTNNHTNNNNHNNNHHNNNTNNBNHHNBTNNNNTNBHTNHHHTNNNHNHTT
BNHNNNTHNNNHTNTHNNNHNNBNTNNTHNNNBHTNTNHTNNBHNNBNTTHNTHHNTTNTTNNHNNBNHNNNNNTNBNNNHHBTHNHNNHTNHTNTHNTH
NNTTNHNNTTBNHHBHHBNBBTNBNHTNNBNHBBHNNHNNNNNHNHTNTNNTHTNHNBBHTNBHBNHNTTNBBNNTHNNBBNBHNHHTHTTNNNHTTNHB
NNNTHHNHTTNBTNNTHHNTTBHHHHHNHHBTNHNHTHTNNTNNNTTTTTNBTNHNHHTTTHNNNNNNTHHHNNHBNTNHHNHHNTHHHBNNTHNNNNBT
NTNNTTTNNNNNNHTBHTNTTHNHNNTNHHNHNTTNHNBNNTHTNBHTNNTNTTNNNNNHNNNHHNNNBNNNNHHNNHHTTNTHNNHTNHHNNHNNTNTN
HNHHBNTNNNHNHTHNNHTNTNHHTNHHBTNNNBNNTNBNTHTTNNNNBNHHNBTNTTHNTBBNNNNTBNHTBTNNHNHTBHNBNNHNNHNBTNNHNBTN
NNHTNBBHTHTNNTNBTNHNNTNNBNBNNBNNNNHNBHNTTNTHNNNHNNNNNNNNTHHBTBHNNTNNNHBTNNNNNTHBNNNHTHTNNNNTHTTTNTNH
NHNBTNNTBHHNBTNNNHHNHNNBTNNTBTBNNNNBTNNTBBNNNBNNNNHNTNHHHNNHNNNNHHNNNBNNBNTTNNHTTTTHNNNTTBTNNTBTNNNB
BTHNHHNNHNHNNHTNTNTNNNTHHBNNNTNNTTNTTNNTHTBNHNNNTHNNBHNNNNBHHHHNHNNNNNTBNHNNHNBBBTHNNNNTTNBTBBTBNNHT
HNHNNHNNHNNNHNNNNNNTNNBHHNNNNHNHNHNNHNHNTNNHNTNHNNTNBTNNTNNNNNTNTTNTTTBBNTNNNNNHNHNNNNNNTHBNHNNNBHNB
NHHHHBNNTNHBTNHTHTNNHNTNTTNNNNNNNNHNNNTHHBTHBNHHBNBTTTTNNBNBHNTHNBTHTTTNHHNTHNHTTNBNHBBNNNHNTNNNTBNN
HNNNHNBHHNNHNNNNNNTTBNHNNHBNNBNNNHHNHNNNNNNBHNNHNNNHTTBTHNNHHNNNNHNNNNNBNBNBTNHHNHNBNNTNNNHTTNBTNNNB
NHNBHNBBNNTNHHTNNTTTNNNBHNTNTNTNTNBTTNNTNNNBHNNNTHNTTNTNNHTTNNNTHNNNNNTNTBHNBTNNTNTNNNNTHNNNHTTTNNTN
TNBNNTNNNNNBTNBNNTNNNNBNTHNHTNTTNNNHHHHNNNHNNTTTHTTNNHTBNBTHTNNNNTHHNNNBNBTNNNNNNNNTTNTBHTTTHNBNNTNN
NBNTNHBHNHNNHNHBNNHNNHTNHHNNTHNTNTNNNNNNNBNBHTTTNNTNHNHNNNHNNTNHNHNBNTNNNNNTNBBHNNNTNNNTTNNNNHNBNHNN
NTBNHNHNNNHNBNNTNTHNTTHTNHNNNHTNNBNNHHHNTHHNHNHHNHNHHHNNTHHTTNHBBHTNHNHNNNBNNNBNHTHTNTTTNNNNNNTNTHNN
NTNNNNNTNTHNHNHNNBNNNNNTHNHHNNNTTTHHNNTBNNHBNNNNNNNTHTNTNNNNHHHNHHNHTTNNHNTHTHNBNTNHHBNNBTNTNNTNNBTT
HNNNNHHHTNNBNNBHBHTNNNTNNNHBNNNNTBHHNNNHHNNNHNNNTNTTNTBNBNHNNBNHNNNHNTNTNNNNHTNHTBTTTTNBNNNHBNTHNNNN
NHHHNNTTTTNNHBTTHNHBNHNNHNNTNBHHTBHNHHNNNNNNTHNBNNNNNNTTHNHNNNHBNNNTHTNTHNNNNHNTNTBNTTTNHNHHHTNHNHNN
NTTBNNTNNTTBNNNTNNNNNTTTNNTNBNHNTNHTNHBNNHTTNNNHNNHNNHTTHHTNTBNTNNHNNBTNNBTTTNNBNHHNNHTNHTHNTBNNTNNN
TNNNHTNNBNNBTNHHNHNTNTHNNNTNNBNHNNNNHNNNTNTTHNHBBNNNNNTNBNHNTNHNBHTNNHTNHNHHNHBNTHTNNHTTNNTNTTHNNNHT
BNBNNTNNNHHBBNNHHNNBNHBHBNTNNNBTTNNHHNTNHNNHNHNTNHBNTBNNBTNNNNHHTNTNHNNBNBTBHTNNBNHTNBHTTBHNNHNTTHBH
BNTNNNBNNBTHNNNNTNNHNNHTNNNNNTBNNNBTTNTNTTTTNNHTHBNNNBNNNNBNNNNNTHNNNNNHHNTNNNNTHNNNNNTNTNTHTTBNNNBN
NHNHNHBNHTBNTHNNNNNTNNNHNHNHHTTTHNTNTNHNNNHNNNTHNHTTTNTBNHNNHNNNHHTNNNBBBNNNHBTNNNTNNNHNNNBNHNTHNHTB
NHNNBNNNNHNHTTHHHNNHHTTNBNTNTNBNNTNNNNNNNTTNTNBNTTHTNBHHTNTHNTNTHNNTTHNTBNHNNHBTNTBTNNHTHNHNTNNHHNTH
TNBTHNBHNNNBTNBNHHHTTNTNHNHNNTNTNNNNHHNNNBNNTNNNNNNNNNNNBHHNTNTNNNNNNNTNNTNTTNNNNNTNNHNNHHNBTNNTTTNN
HNHTNNNTNTTNNTNHNNTNBTNBNBNHBHTBNNBNBHNBTHNNTNNNHBNHBBNNNTNHTHNNNHHTNHNNNBTHHNNNTTHNHTTHHHNNNHNHNNNT
NTNNNHBNNNNHHNTTHTTTHNTNHTNNNNTNNNTTTNHHHHHTNTHNNBHTNNNHTTNNHHNHHTNTHNBNNTNTBNHHBNTHNNNBNNNNTNNTNHTT
BNNHTNNNHNNBTBHNBTNTNNHNHTNTBHNTNTNTNNNBBTTNNTTNNNNNBHNHNTNNTBNNNNTNBNNNNTNNHNTBTHTTNBBTNNNHBTTTTBNN
NTNNNNNHHNTNTNTTHNNHTNTNNNHNTTNHNHTHTNNNHNNTNNNTNHNHTNTTTTNNNTNNTNBTNNHHTNHHHNHHTTNHNHNNNNBNNTNHNNTH
TBNTHTNNBTBTHNTNHNNHNHTNNHBNTNHNNNNBTNNNNNHNNTNBTNHBHTNTTNHHNNTBTNNNNBHHNBTNHNBTNTNHNHNHNNNNHTTHHTNH
THHTNNNHHTNNNBNNNNTBHNNTNHHTHNNBNTNNTHTHNHHNNTNHNNNTBNNTNTTBTHTTNNNNNHTHBHHHHNNNNNHNNNNNBNBHNNNNBHHH
BNHNHHTHHTTTNNNNBTNNTNNNTNBBNBBTHNHTNBBNNTBNTNTHBNNHHTHNTNNNBNNHTNTHHBBBNNNTNTNNHNHNHBBBNBBNNBTHNNHN
NNTTHTNHNHNNBHTTNTNHNTNHNTTNBNNNHBTTNTNTNNNNNTNHNBBHNNTBHNHHBHNTNTNNTHTHHNNNNNNNHHBBHBNNBTHBHNHTBNNN
TNNBNHNNNTNHTHNTTHTTNNHNNNTNHTNHBNNHNTNNNNNHNHNNNHNHNNTNTNHTNTBTNTNBBBTNNNHTNBNHNHTTNHTHTBHNHTNBBNNN
THHNHNNNTNNTNTHNNTTNNTNNNNTHNTNNBNNBNTNHNNHNTNBNNNBNTNNNNHNNNNNNNTNNHHNNNHNTHNNNTNNNHTTHHTNNHHNNTNHH
NNHNNNNNBNTHHHHTHTNNHNNTNNNNTHHTNNNNNNNHNTNTHTNTNNHBBNHNNNHNNBNNNBNBTNNBHTHNBNNHNNHNNBNNBHNNTHNBNHNN
NNNNHHNNTTTNNHNNTNBTNNNTNNNNNNTTTBNTTNBTNTNNHBHNNNNNNBNNNNNHNNNTNHNNBTTNNNNNBNBNTNBTNHNNTNTNNNTTNTNB
HTTHNTHNTBNTNNBBNHNBNNNBNNTTHNNTHNTNHTNNNTHNNNNNHNNNNBNHHTNHTNNNBHBNTHHTNNNNNTTTNTTNNHNHTNHHNNTNHHBT
BNHTNNNNNBNNNNNNTNNTNTBNNBNTNBNHNTHTNHNNNBTNBTHBNNNTNNNNTTHNNNNHNNNBTBNTNNNNNHNNNNNNNNNHHNHNNHBNHHBT
NNTHTNHTBNTTTNNNHNTTTBTNNHHNNTHTTHNNNHNNNBNBNTBNNNNBNTTHTNNTNNNTNNBHNNHNNNNNNBBHNTNHBNNTHTTBNNBBHNTT
NTHBNNNNHBNTNNTNNHTTBTBNTNTBBNNTNTHNNBNTHTNBNHNBBHTTNHNBBHBNTBHBBNTTTHNNNHTNTNNHNTNNNHTTNBNNNNTBNTNN
HNNBBHNNNNHTNTNHNNBHBNBHNTHTNTNTHTHHBTHNNBHNHHNHHNNNNBHHNNNTTNTNNHTNHNHNNNNBNNTNNTTNHTNTNNBNHTHNNTNT
HNTBTNHNBTNTHBHNTTNHNHHNNTNNNTNHBNNNBNNTNNTNNHNNNBNBTNNNTNHHHNHNHNNTNNNHNTHNNTBHNNNNHBNHNNNHHBHHNNNN
HNNNNNNTNNHNNBBTTTBNTHNHTNNNNTHNNNNHHHHNHBNNHHTBHHHNHNNNHNTHHHNTHTTHNNNNNTNHNNNTHNHNHNHBHNNNNNNHNNNT
BNNNNBTNTTHTTNTNNHTBTNTNNHNTNTHTHTNNTNNHHNTHBNNTTTNNHTNBTNNNTHTBBNNNHNNTNNHTNNHNNNNBHNNTHNHHNNNNNBHH
NNBNBNBNHNTTNNNNNNTHNNNNBBHHNNTNHTNTHTTHBNTTHTBHHNTNHNNNHHNNBNTNNNNHHTNTBNNNNNHHHBNTBTNNNNNHNHBTNNTN
HHNTTNNNNTHNNTHNHHHTHHBTNNTHHTNTTNNNNHHHNTNNBBNNTNNNNNNTTNNNBNNNNNHBHNNTTTBNNNNNNNNHBNNNBTNNNNNHNNTH
THNTHHBNNNHNNBNHNNBHHNNNNTNNNTNHHNTHBHNBNNTHNHHHNNHTNTBTNBTHTNNHNNNNTHNHNTTTNTNNNTTNNNHNTNBNTNNNNTTN
HTHNNNNHHTBNNHNNNNNNNNNNHBHNNNHNHHNNBNHHNHNNNTNNHNTNNBBNBNTNHTTTNNHTBBNNNNTNNNNHNBBHNTHTNTNNNTNHNNTN
NTNHNTHNNHTTTNNBBHNNNBTHTNTBBBTTTHNTTHNHHHNHBTHNTNTNBHTNBTNNNNBBNTNNHBTHTHNNNTNNNNTNNNNNNTNBHTNTNNNN
NHHHNNNHNNHTBNTNNBNHHBBNNNNNTNHHHHHTBNNNNHHHNTHNBTNNNNHHHHTTHTBNNTTTNNTNNHNTNNHHHHNHNNTNTNNHTTTTNNNT
HNNHHTNNNNNTNHNNTHNNHNTHNNNHBNTBTNNNNNNNBTBBHTTHTTNBBNNNNHNTTNTNBTTNNNHHNNNTNTNTNHHTHNNNTHHNTHNNTNBT
NBNTNNTNTNTBBNTHHNNNNTTNNBNTTHNTNNTBHNHTNNNHTTNTNHNTHNNBNHNHTNHNNBNTNBNHTNNNHTBTNHNHNNTHHNTTHHNBTHNT
NTNTHHHTNTNHTHNTBHNNNNNHNHHTNNBHNBNNNBNTNHNNBTBNTNNHNHNHNTNHTNHNNHNNHHNNBNTNHBTNNHBTTNTNHHNNNBHNBBBN
NNNNHHTNHNHNNHNNHNNNNTTHNBNHNHNHNBNNNNBNNHHHTNNNHBNNHNBBHNNNNNNBTBTBNBNTHHTNNNTHHTNNNHTNBHNTNTNBNTHN
NNHTBNNNNTHNHBNNBNNBNNNNHNNNNNNTHTTNNHNTTBTNNTTNNNBNNNBHNHTBNBHTHNNTNNTBNNNTTNBNHNHNNNNNNHNNNNTTTHTH
NNHTNNTNTNNHHHNNNNNNNNTNNNHNBNNTNBNNNHNNTTNNNHBNTNHTNHTNNBTNBTNHNNNNBNNNTBNTNTNTHBTNNTNBBNNHNNTNTNHN
NHHNTNNBTTNBNTNNHNNBNNNNHHNTNNNTNBHHNNHNNNNTNNNNNNHNBNTNNBNNNNNHNNNNHNHHTHTNTNNHHBHNHNNNTNHBNNTTNTTN
HNNHHNNNBNNTNHHTHBNTNHNNHNNHTTNTNNNNBHNTNNNTHTHBNNTHNNNTHNHNBBNNNNNTBNBBHTTTTTNTNNTTNNTNNHTTNTTTHNNT
BNTNNBNBBHHHHNNTNTTNTNNNHHNTTHNNTNNNNNHHNBNNNNTHNHHNNNNNBNTBNHNTHNNNTNNBNNNNNNBNHNNNHTTHNTNNHHHTNTTH
TNBTNNHNNNTNNHHBBTNHHTHNHNTTTHNNHNHNNHBNBNNBNNNTTTHNBNNNBHNTNNTHNNBTNTTNNHNNHNTBNNBNTHBHNTHNTNHNNTNN
