(97, 94)
NBHHNNTTNNTHHHHNHNBBHNTTHTNNNNNNNTNNTNNTHBHHBTNNNNNTNTHNHHTTBNHNNNHTNHNTHHNTTTHBHNTHHTNNNHNTTNNTHTNT
HNTNNHNNNNHBBNNTNHTNBNNTNNBNTTNNNTTNNNBNTTHNTBNNHNTHTNNHNNNNNNNNNNTHHBNNNNNNBHNNNNNHHNHTNHNTTNNNBNBB
NTNNTHTNBTNHNNHHBNTNNHHBNNNNHNNHTNNNNTNTTNNHHNHHTNNTNNNTHTHNNTNNBBNNNNTNNTNNNNHBNNBHNTNNNHNNHHHNNBHN
HBNBHNHTHHNHNNTNBHHTNTBTBHNNHHNTHHHBHNNNNTNNTTTHNBNNHNTNTNTHHHNNNBBTNTBHBNTHNNNNHNHNHNTTTBNTNNNBTBNN
NHNHTBTNNNHNBHHHNBTTNHNBHBTNTTNTTNNNNNNNHTBHHNNTTHNHNHBHNHTNHNNTBBNBNNHHNNHBNBNNTNNNHNBNHNNTHNNNNNBN
NHNTHNNNBNNHHTTNNNNNHNBHNTBHHHNNNHTNNNHNHNTHNNNNBNBHNNNNNTBHNNTTHNNNNHNNNTTHNHTNNNTBHBNHTNNNTNBNHHHH
NNHBNNBTNTNNNNNBBNNNHHHTNNHTTHTNNNHNNNHTTHNNTBTNBBNHNNNBHNNTHNNNNNNHTNNNBNNNTTNTNNNBNTTHHHTNTTHNBTNT
HNNNNNNNHNBNHNNBHNBNHNBHTHNNNNNTHTHTNNNBNHTNNNTTNNTHHBNNNHHNNNNBNHHHBNHNNNHBNNBBNBBHHNNNNHTNNHNNTTNN
BNNBNBNNNTTNNNNTHBHTNTHHHHNTNNTBNHBNTHNNNHTNHNNTTBNNNNNNNHTNNTBNTNHNNBBHTHHNNTTNNHBNNNNNNBHNTTNHBNNN
NNNHHNNHNBBHHHTTTNBNNNNNNNTNNNTNBNNTNNNNHHHHTNNNBNNNNHNHTNHNNNHHTHNNBNBHHHBTNNTNTHHNNTTHHNBNNNBBHTTH
TNTTNNTNNNTHNNHNBBBNHHBNNNTBNNBTBNTBHNNNNBHNBNHTTBNNNNNHNHTNTNBNNNNNHNHHTHNNHHTHNHTNNHTNHHHNHNBBHNHH
NNNNNHNBHNNNNNTHNNBNHNNTNBTNNTBBNTNBNNHTTNNNNNTHTTTHTNHNNTHTNNNTHTTHNTHBNNTNNNTNNHHNHNNNHNNHTNNNNBNT
NHBHNNNNNNNNNTNNNNBTHNHBHNHTNBNHNHNTNTNNBTTHTHTNNNTNNNNNNHBNTNNNHHHNHTHHNBNNNNNTNHNHBBHTNNNTNTBNNHNT
NBBNHHHNNNNHNHNNHTNBNHNTHNTTHNNHNTHNNNNHNTNBNTNTHTNTNNBTNNTNNBHNNBNNNBTTNHNBNNHNNNHHTTHTNNNNBNNNNBTN
NNNBNNTNNNBHNTNBTHTNNTNBBNNNNNNHNNBNNNTTTTTBNNNNNNNHNNBNNTTNNTTHBNTNHNNNHNBTHBTHNNBNNNNNBNHTBNNTNTNH
THNTBTTNHNNTNHNNTHNNHNHHHNNNNNNNTNBNNNNHNNHTTHHNNBHNHHTNNNHNNNNNHNBNHNTBNNNHBHHNTTNHHTHNNNBBTNNNTNHB
BTNHNTTTTNNBHNNHHNTHNTNNHNTBNTNNTHNBHNHNNTTNTNNHTNHBNTNTTHNNHNNNHNTNNNNTTNBNHTNNNNHNNNHNBTHHTNHNNHNH
HNHTNNNHTNNNNNNNNTNBNNNNNTNNNNNTHBNHNNTNNBBNHNNNNNTTTTTNTTHTNNNNNNHNNNNHHTNBHNHHTNNNHHHNNNNHNNHNNNNN
TNHTNHNHTNNBTNTNBNNBNTNNHBHNHBTNNTHNNTNNNTNTNNNHHNTNBHNNHHBNNNNBNNNHNNHBNNTNNNNHNHNTNHTBTNNHNTNNHHBN
THHNBHTNTNHNNTTNBNNNNBTTNNTNBHTHNBNNNHNBNNHNTNTNNTNHNTHNNHTNHHHHNNNTNNNTTTNTNNTBHBNNTBNNTNBHNHHTNBNT
TNNNTHHNBHNTTTNHTNHTNNHNHNNHNNHNHBNNNNNNHHNNNTNHNNNHNNNBBTBBNNTNTNTNHTNHHNTNTBHBNTNNTNNHHNHNHTTNTTNN
NNTNHNNTHTNTNNTNNTNNTTBNHNNBNTNNNHHNNHNHNHNBNNNNHNNTNHNNHBTNNBHNHNHBNNNNTNNNNNTNNNHTHNTNHBBNNHNTNTNN
NNNTHNTHNNNNNNTBTNTNTHNNNHNTNNTNNNBNNHBNNNNNTNHNNNTTNHNNHNTHNTNNHNHNNNTNHTNTHHNNNNNHNHBNHTTNNNHBHTNN
NTNNNNTBNHHTTNHNNTHHHNNNHNNBBNNNHBTHNHBBNTHNBNNNNTNTNNHNHTNHTNHHBNNNNTTNTNTHBNNHNBBNHHHHNTTBNHHBTTTN
NNHNHHTNBTTNNTHTNHNHBNNTNHNNTHBBBHNTNHNTNNHTTTBTNNTNTNNNNNHBHNHTNHHTBHNTNNNTNTBNHNNTBBTTBHTNHNNNBTBT
HNNHNHBNBNNNNHHNNNTNHTHTNNNNNNTNNHNHNHNHNBNTTNNNHNNBHTHNHTHNTNNHBNNNHNBHNBTTBNNTNBNBBTHNNHNNTTBNTNNN
BHNBHHNNNTBNNNNNTNHTNTNNNNNNNHNNTBHHNNHNNTTHTHBNTNNTNTNBTTNNNHHHNNTNNTTNNNBTTTNHTNNHTTNTNHHNNNTNBTNT
NNNNNNNTBHTTBTTNNNBNTNBNNNHNNTNHTNNHNNNHNNHNNNNBHNTNTNHTTNNHHNHNHTNTNBNBHNBTTNTNNHBNNTTBNHNNNBHTTNHH
BNNNNNNNHHHNNNBNBNTNTTNHTTTNNNNNBNHNNHNNNNNNTNTHNTNBTNNNNTBNHBNNHNTBTHTHNNNBNNNNNNNNNNNNNNNTNHNNHNHN
BHNHTTNHNNBNBNNNNNNHHBHTNNNHTNNTNTNBNNNNTTNBTHTBNNNHBHTTBBNTTNNNNHNTTBTNNNNHNHTTHNNHBNNTNNTHTHNNHNNN
NTBHNNBNHNTNNNTNNBNHTNNHNTHNTTNNNBNNNNTNTHNTNNNNHHNNNNHTTNNNTNTBHNTNNNHTNNHNNHBBNHNNNNTNTNNHNHNNNNNH
NNHHNNHTNTBNTNNTNTHHTNHTTHNNNNBNTTNBBBHHBHHTBHTNNBNNBTNNNTHNNHNNNHNNTNNNNNNNNNTHBNNHNNBBNTBNBTHHTBHN
NBHNNHNNBNTNNNHNNHNHHHTTHNNNHTTTTNHTNHTHNNTHBHHNNNTNNNHNHTTBHBNHNNNNTTTHTTTBNTNBBNNHNNNBBNHNTNBHTNTT
NHBTTHTNTNNTNHNNNNNHNNTTTTNNTNTBNNNHNHTNNNNNTHBNNHTNBTNNHBTTNHTHTNBTHTHNNNTNBBHHHNTNHNHHNNTNNTNHHNBT
NNHHNHNNNBNBTNNHHNNBNHNNNHNTBTNTNNHNTNTHTTHNTHNTTNTNNNNNNBNBTNTNNTHTNBNNNNTHTHNHBNHTHNTNHNNTNTNHNHHN
HBTTTNHHNNTBTNNNNNTTHNNNHNHTTTNNNNTTNNNHNTHBTNTNNNNNBHNBNNHTNTNHNNNNBNNTBNHNTNBNNTNNNNTNTHNNNHHNTNNN
NNNNNNNHTHNHTNTTNNHTNHTTNHTNNHBBNNNNTTHTNTTHNNNNTTNTNNTHHTNNNNHNNBBNTHBHNNTHNHBTNNNNHNHHNNNTTHNHTTNT
NNNTNNNTTHHHNNBNTNBNNBBTNHNNHNNNNNNBHNBNHHHHTTNTTNBTNHBTNNNHBTNNNTNBBHTBHHNNNNTNHNTNNHNBBBNNNHNNHBNB
NHHNHHNTNHHNNTNHNHNHHHNNTNNHNNBNNHHBNNNNTTHNNTHNNHNTNNHNNHHNHNNNHNHNHNNBNTTTHBTNHHNTNHHTHTHHBNHNBNNN
NNHNNNNHNNNTNNBNHHHHHNTNNNTBTTNHNNHTBNNHNNBBHHNNHHHHNHNHNBNNNBNNHNBNBNNTNNNNNNNNTTTNHTTNTNNTTHHNNNBN
NNHTTNHTTBNHTNHTBNTNNHTTNNBNNNTHTTTNNNTNTTHHNNNTTTHNNNNTTTTNNTHHHNBNTTNHNTNHBTNNTTNNTTTNNTNNNNTNHNNT
NNNNBNTNNNTNBBNNHTNNHBNNHBHBNNNHNNTNNTHNBHNNNTHNNTHTNHTHTNHNHTNNTNNNNNNNTHNTTHBTTNNNTHNNBNHHBNBNTNHT
TNHNNBTNTNTNTTNTNNTTNNBBHBNNNNNNNNTNNHNNNNTNNNNHBTHNHHNNHNHHTTBNHNNNHNNBTHNHNTTBHHNTHHNNNNNTNHNHNBBN
BTNTHTTTTBHNNTBNNNHNBNNHNNNNHTNNNNHNHNNNNNHHNNBNNNTNNTBHTNNTBHBNHNNNNNNNNHNNTHNNNNHNNNNNNNNNTBHHBNNT
BTNNNHHTNNNNHNHBHNNNTHHNBNBTHNTNTNNNNHBTHTHNTNHHNTHNHHTHHNHHTNHHNTNHBHHNNNNHTNNHNHNBBNHTNHHNNBNNNTTN
NHTBHNNNNHNNNTNTNHNNNTHNTHNNHNNTHNHNBNNNHNHHHNNBNBTBTTNTNNNNHTTBBNNBNHNTNTTHTNNHTNTBNNTTNNNNHNNTTHNN
HNTTNNHNHHBNHHNNTNNBBTBNNNNTTHBHNNBNNHHTHHTHHNBNTHNTNBNHHNNNNNTHNHNTNHTNTNBHNHNNNHNTTNNNNNBHNNTNHTNN
TNNHNTTHBNNBHNNNTNHHNNTHHNTTTNTNNTNTBNHTNNNNNNNHHNHTNHNBTTNTNNBNHHHNNHHBHTNNNHTNNHHNNNNNNTHHTHTHNNTN
NBNBBHNNNNNTNNNNNHNNBNNTHNNNNNNBNNNNNNNNHHNTHNNNNTNNTNBNBNBBNBNTNNNBTNNNTTBNHBNBNBHHBTHHTHHHNNTTNNTN
TNHHBHNTNHNNNHNTBNNNNNTTNNNNTNHHNNNTNHNTNBHHTTHTHNTNTNTNHNNTTNTTNTTHTTHNTTHTNNHNNNBTNNBBNNNTTNNTNNNB
NTNNBNNNNNNTNNNHNHHNBNNTNNNHNNTHNHNNNTNNHNNTTNNNNNNHNHTNNNNHTTHBHNNNHBNNHNNNNTHNNNHNHBHBNNTNTHNNNNBT
TBTNNNNNTHNNNNBNBNNHTNNNHNTNHNNHTNNTHHTNNNNNBNNNNTHHHNTTHNTTHTNHNHHNNHNNHHHTTNTTNNHNTTHHHNBTNNNNNNNT
NTHNBNNHTNNNNTNHHNNNNNHNTBNNTNNHNHNBNNTTNBNNHNNHHHNTHHNNNTNHNNNTTNNHNNHTNNHTBTNNHTTTHHHTNBNHBHNHHNNH
HNNNBNBNNTNHNNBTNNTHTNNNTNTHNHNTHNNHBNNTNNNNHNTNHNNNTTHNNNHNHNNNHHHNNTNHHTNNTNHNNHHHHBBTNHNNNNHNNHNN
HHTNNNBTNNTNHHHNHNBBTTNTNNBHNNNTTTTNNNNNNTNNNBNHHTNNNNNNHTBNNNHHNNHBTHHTNHNNBNHNNBNNNTNNTNTHTTNNHHNB
NNNNTNNNTNTNHHNNNTNNTNNTNNNHTHHNHTTTTNNBTHNTBNNHNTHHNHHHNHNTNNNTNTNHTNHNNTNNNNNTHNTHNBNNBHHNHTTBBNNH
BNHHBNTNNNNNNNTNNHHNTNNNNHNHTNNNHHHNNBHNHNBNHHTTBBTNTHNTNTNBHHNTNHNBNTNBTBHHNBNNNNNNNNBTNNNNBNHNBNNN
NHTNNNNNNNNBNNBBNHTHNTNNBNNHNNNNHNNNNBTNTNNTNBNNTNNNNNNHNNNHHTNNHNNNNTTHHNNNNTNNTTHBNBNHTNHHTTNNNTHH
HNNHHHNTNTTNNTNNBBHNNNHNTNNHTNTHTNTTTTTTNBNNNNHNNNNNNHNNBNHNNTNNBHNTHBNBHHHNHNNHHHNNHHNTNNTNNNNNNNBT
BBNNTTNNNTTNHTNTNNTBNNTTTNNTTHTNNNNNNHHHHNHNNNHNHBNHNHNNNBNHNNNTNNNNTNNNTNNNNNNTTNHNNTHNTNBTTNNNNNTN
HNNNNHTNNTNHNNNHNTBNNNNBHTTBTNBHNHNHTHTNNNNNBNNBNHHNNTNNTNHBNNTNNHNNTNNHTTNHNNHNBNNNNNTBHNTBBTHTNNNN
THTBNHTNHHNHTNNNTNHHTNHHNNTNTBHNNHBNNNTNHTHNTTNBTNHNNHNNNNTHNBNTNNTNTBHNHNTNTNNNTNNNTNNNNHTBBTNTTHTT
HHNHBTNTNTNHNNNNNNHBNNHNHNNBNNNNNNNHHNNNTHTNBBNNBNNHHTTNHNNNHNHNNNHHNNNTNNNNNTNTNHBNNBNNBNNHHNNNNHBH
HNHHNNNHNHTNNTHNNNNNNNHNHHTNTNNHTNNNTNTHNNHNHNHBNHHNTTNHNBHBHTTTTTHNTHTTNBNTBNTTNHNHTNTNHNHNNBNTNBNN
BTTTNNNBNNNNNHBNBBNNNNNNTHNTHNNTNTBNNTBNNBTBNNNHTHNBTHNHNNTTNNBNTBNTNNTNBNNNHHTHNNBNHNHNHTTBNTNNTHNB
NNNBHTNBNHNNNHTNNNBBNHTTNNNHBHNTBNTHNNTNHNHNNNHNNNNBNNTNNTNTTNNNHNHNNNTNBNNTNNTHTTNTTHNHNNTHNTNNTNNH
NTHNNNTNHNHHTNTTNHBNNNBHTNBNHTHNNHNTHHTNHHHNHNNTTHHHHHNHBNTTNNHNNNNNNNHTNNHTTTTBHNNTNNNHHNNNHTTNTNNN
NNNNTNNHTNTNTBBNNNHNNHNHNTNHBNNHNTBTBNNTTNNNHTNNTHNHBNHTNNHNNHNHNTTHTBNTNHNHNBBTHNBNTTNNNNNHNNNHTNHB
NBNHTNHNTNNNNTNBHHNBNHHHBNHHHTNHTNNNNNHNTTHTTNTNNTHTBTTHBNHNHHNNHHNBNNNHTHHHBNTNHNNNHNNNTNTNBNHTNNHN
HTNNNNNNTNBBTBNTNNNTHTBNTHHTNTTNNHHHNNBTBNTTBNNNHNTNBNNTNTHHNHNHNBNHTBNNTTBBHNNTNNNNNNTNBTNBTNHTTNTN
TNNHHNTTTHNNTBNHBNHTBTNHBTTHNBNNTHNHBHTTNNNTNHNNBNBTNTHNNNNTHNNTHBTHTBTHTTNNNNNNNBNNTBTNHNTTNTNTHHBB
NNHTNNTBTTNNNTNNHNTNNTNTNNTNBHNHTTHNHNHTNTNTTNNBNTNNNBNBNNHBNNNTTTHBNHNNNNNNNNNBBBTNNTNNHNTNHNNNNNHN
NNNNNHBTTTBNHHNBTTNTHHNTHNNHTTTNNHNNNHNTTNNNHHBHNNNTNNHTNBNTTTTNTNNNNNNNNNTNTNTNNTNNNNTNNTTHTNNNNNBH
NNTHNHTNTNNTHNTNNHNTHTBNNHTNTTNNNTNNTBHNNNNNBHNNTTNNNHBNHNNNHNTBNNBTHNNNNHNHBBNNTNHTTNTHNHNNNTHNNNNN
NHHNNBNNHNTTHTNBNNNNNBNNHNNNNNBNNNTHNNTNNTHNTTNHNTNNHNTNHTNTNNHNTHNHHHTNBHNNNNNHNTTHBNBNHNHHHHNHNNNN
NBNBHNNTNTNHNNTNHNTBNHBTNNHNNNBNBHTNHTNNNHNNTNTNNHTNHTTHTTNTNHNBNNTTNTHNHHTHTTNNNBNTNBBHTHNTHNNNHTHT
HNNTNNTTTHTNTHTNHTBNNTHNHTTHNNNBHTNNNTHNBTNTNNNNNHNHBNBNHHNNHNBNNBNHBHNNNNNNNHHNTTTTNNNNNTHNNHTNNNNN
NTHTTNHNHNNHHTNNNHNBNNNTTTNNNTHNTNNNHHNHNNNNNHTHNTNHTNHNNTNNHBNTHNHTBNNNTNNNTTNTNHNNHNHTNTBNTNTHTTNN
NNHHHTHNNNTNHNNNTNNNNTNNNNHTBNNNNHNTNNBNTNBNNNNTTHHNNTNNHNHTNBNNNHNNNTNNNTNBTNHTHNTNNHTNTNTNBNNNBTNN
NTHHNTNNNTNHTBTHNHTHNHNNNNNNTBBTNNNTNNHBTNHTTHNBNTNNTHNNBNNNTNNBBHNNHNNNHBBNNTTBTNNHHHNTNTNTTNNNNHTN
HTNHHBNHNNNNNBNTNHBNHNBNHTNNNBNNNNHNHBNNNBNNNNNHNNHBNHTNBTTNNTNNNNNBHHBHHNBHNNNTBNHNTNHNTHNBNNNNNTNT
HNNHHTNBNBNNNNNTHTBNNTNNNTNHTNBNTTHNBHNBTNTNHNTNNNNTTTNBNTNNNNHNHNNNTNNNNNTNNHHNNNNTTTTNHTNBNNTHTNHN
HNNHTHNBNTHHHHNTNHBHNNNNNNNNNHHNNTTNBNTNTHHTNTNHNNHNNHNBNNNNNTBNHTNNNHNHNBNTNTTNNHNNBTNNTNHNHTNNNNNN
NNHNNNNBNNNNTTHNNNTBNNTNNNNNHHTNNBHBHBBTBTNNHHTTHTNNNNNNHTNNNHTNBNNTNNHNHNTBBTHBNHNHNNNNHHHHNBNBNHNB
TNNNNNTBTHNHNNNTNHHTNNTHNTNNHBBTNBNNNNHNHBTTNHNNHTBHTTTNBNHNHBHNNNHNNNHTTNBNNHHTNHHBNNNNNBNNTHNNTHHH
BNNNNNNHNNBHBHNNNBNTNTTTNTBHHNTHTNNNNTBNNHTNNBTHNHHBNHNNNTNNNNNNTHNNNNHTTNNNHNTNBBNTNNNNNTNNNNNHBNNB
HHHBNBBTNNTNNNBHNBNBNBTNNNBNNNNBNNTNTTNBNNNTTNNBTHTHNBNTNNNTBNNNHHNHHTNBNNNBNNNHTNHNNNNTHHNHTBTNHTBT
BNNHNTNHBHTNBNHHNBNNBNTTNHNBNBTNHHNBTNHNTNBNHNNNBBTTHHHBTTNNNHNTNBNHBBTBNHHNTTHNNNNNBHNNHTHNNNNNNNHN
NHNTNNTTNNBNTTTTNNNTTHTTNNTNHBNNTHNNBTNNBNTTTNNNHNNBTNHTNTNNNNTHNBNNNTHBTNNNHNBNNHTHNNHNHBNHNTBNNNTB
HHNNBTTNHNNNNHBHNNBNHNNNNNHNHHHTNHNNNTHNNNHTNNBNHNTNNTNTTNNTTNTNHHNNHNTNHTTTTTNBNBNHHNHNHHTNNHTNNNTB
TTNBNNNBTBNHNNNTTBTNTNTNNBNNHNNHNHTNBNNBNHNHHNBTTHNNBHBBNTHNNNTNNBNHHNHBTNTTNNNNTTNTHTNHTNNHTBTBHTNT
TBTHHBTTNHHNNBBNBTNTNBHBNNHBNNTTNTNNNHNNTHNBTTBNNHNTNHNBHNNNHHNTNTBNHTTNNBNBNTHHTHNNBHTHNHHNHNTHNNNN
HTTTNHNHTHNNBNTNNTHNHTTTNNNHNTNNHHNHNNNNNTHNNNTNNNNNBNNTNNNTTHHNHHNHHBHNHNBNNNNHNHNNHNTTBHNNHTHTNBBH
TBTTNNNBNNNNNNBTHNNTNNHHTNTNHNNTHBNNTHNHNTNHNHHTNNNNNBNNNHTNNNNBNHNNHBNNNTTNNNHBNNTNNTNNNHTTTTHTNNNH
BNBNTBHHNHNNTNNTNNHBNNNHTNBNNHHHNTTNBNNNNTNNNNBNNHHNNNNNNTNHTBNHBNNTNTTNHNNNNTNTNNTHNTTNHHTNNTBBNBBN
TTNNTHNNHHNBNBNNTHBTHNNTNTTHHNNNHNTTNBTNHNTNTNNNTNNNBNHNNBHTNNNBNNTBTBHBBTTNHBNNBNTHNTTBNNNHHNNNNNNN
NBNNNNNNTNBNHHNNHHTNHNTNTTNBHHTNNNHHHHHHNTTTBNNNBTNTNNNNHTNNBNBNNNBBNNNTNNHNNTNHNHTNBNNHTNBNNNNNTHNT
TTNNNTNTHNHNTTNTNNNNBBTNNNNTNHNBNHTNNNNHTHHNHNTNTTTNNTBNNNNNHNNNTHTHBHNNNNTNHTTTBBHNTBTNNNNBNTTNHNNN
NTNHHHNNBHNNTNBBHNHTTHNNHBNHTNNHHHBNNHBNNNNTNTHNTNNBTTNTNHNNBTNNBHTHNHNNTHTNHTNNNNNNNHNBNNTNNNHBBTNN
BTNNTTBHHNHTNHNNNNBBNNNBTHBNNHNTNTHHHNTBNNHNNHNNNNTNNNNHNTTTHHTBNNBNNNHNBNHBNNTNNBNTNNNNTNTNBBBNNBNH
