(63, 67)
HTNNBTNNNNTBTNNHNHNHBNBNHNTHNTBTTNNBNNTHNNNNTNTNBTNNBTNNNNHTHBTNTNBNNHBNNBNNNNNNNTHNNNNHNNTBHNBBNNNT
NNNBBNBNNNNHHHTHNHBNNHNHNNNBNHNNNTNNNNNHNNHHHNHNHHNTNTBHTBNTHNHNTNNTNBNNBTNTNHBHTNBTNNTNNHBHTNNNNNNH
TNNNTHNTNBBTNNHNHNHTNBNTNNNNHNNNNNNNNNTBNHHHTNNTNHBNTTHHNNNBNNHNNHBHTNTNNNTNNHNTNTBBNNNNTNNNHNNNNNTN
BNNNTNNHNNTHTTNNNNNBNHNTBHNNHNNHNHNNTBTNHNHNTNHHNBNNBHNTNHTBTNNNHHBTNHNHHTNTNHTNTNNNNNTBHNTNBNTHHTNT
HHNNBTHNBBNNNNTNTNNNNTNHNBHNNHTNNNBHNNBNHHBNNNNNBHTHTNHHNHNNNHNNNNNNNBTNNNNHHNBHNNNNHHNNBBHNTNHNNNNN
NBTNNTNHBHHNNNTTNHNTHNTNTHTHHNHNNTTNNTNNBHHTTNNBNNHBTTTHNTNHNTNNNNNTHNNBNTBNNNHNNTHNNNTHNHTBNNHHNTNN
NNHNTNHTTHNNHNNNHTNNHTNNNNTHTNNHNHHTTHNNNNNNHHNNTNNBTNNTNNNHNNTNNBNHNTTBHNNNTTTNNNTHNNNNTNTNNHNBTTNN
BNNNTNNNNNNNNTNTNNNBTHBNHNTNNNBBNNNNBNHTNNTTTNNTNNNNNHNTTBNBTNTNHNNNNNNTHHTTHTNHTNTHHNHNNNHHNHNTBHNN
NTBHHNNBHNBTTNNNNNNHNHNNHHNBNNNNNBTHBBTHNBNHTNTNHNNHTNHNNNTNNNTNNHHNTHNNNBTNTHNNNNNTNTTNBBHNNNNNTHHT
NNBNTTNNTBNBNNHNNTNTHHNTNHHNNHNTNHNNHNNNHHNNNTTNHNHNTNNTNNNHHHBNNNNNTTNTHNHBTHNNNHNNHHHTNTHBNBNNNHNH
NTTTNNNHNTHHNNNTTNBTNHHBTHNNBNHHHNNTHTBTBHNTHTNNHNTNNHNHHNNNNNTTNTHNNHNTNNTNHNNTNTNTNTTHNBHTNHTTBHNN
NTTNNHTNNNNNNNHTNTNHNNHNNNNHNNNBTNTNHNNTNBNNNBNHNTTHNNNNHTHHNNBHNNTBTTNTNNTNBNHBNHTNBNTNNHBTNHTNHNNN
HNNNNNHHNHNNHHNNNNNNHNNBHNNBNNNNNHNNBNNTHBNNHBNHTNNNNNNNNHNNTNTNNNHNNBHHTTNHHNTHNNNBNHNHTNNNHNNTTBNN
NNBNHTHNNTNNHNNNNBTHTNNNHNTNBNHHNNNTHNTTNHNNBTNNTNTTNTTNNNNNHNNBNHNNHNNTNNHBNHHNNTNNTHTHNNNNNNTNNBTN
NTNHNTNNTNBHTHHHNTNNNNNNNBNHNNTNHTNBNNNTTNNNNNNBNNNBHNNHNNTBBNTNNNTHHTHNTNTNHHHTHNHBNBHTNHNNNTTNNHTN
NTNNHHNNHNNTHNBNNNNNNNHHNHHNBHNBNTHHTNHNNNBNNNNHNNTNNNHNHBNHHNNNTNTTNTNNNHNHTNBNTNTNBNNNBNNNNBHHNBBH
NHNNHHTTTHNTTNHBHNTHHHNNNTNHHNHBTNTNTHTNNBNNBNHNNNHBHHTNBBNNBTNNNNTNTNHHNNNNNHTNNNNNTHHHHTNNNTHBHNNB
TNNBTHNHHTNNTHNNTBHNHNTHTNNNBNTTHNNBNNTHNHHHNNTHNBNTNHNHBBHNNNNNHNTNTTNHNNHNNBNTTHHNNBTBNNNNNHHHNBHN
HBHNBHTNNHNNNHNTBBBNNTNNBHTNTTTNBHNNNNHNTNNNTTNHNTHTHHNNNNHTTNNNHNNHHNTHNNTBNBNTNNTTNNNTNNNNNNNNNTTN
NTTHNHHTNHNBNNNNTNNTNHHBNBNHHNHNNNTTNNNTNNHNNNNHTNHBNHNNTHNHNTBHNTTTNBNHNHTHHBNHNBNHNNNNHTBHTNHTHTNN
TTBHTNHTTBNTNNNTHNTNHTNNNTNNNTBTHNNBNNNNTTNNNNNNNTHTBNNHHTNTNNHNNNNNNHNNNTBTTNNNTNNNTNNNNTNNTTNHTNHN
NHHHTNNNBTHHHTHNTBHBBHNHNNNNNTTHNNNNTBNNNNNNNNNNTBNNHBTTNNTNNTNBTHNTHTBNHNTNHNBHNNNNTHNBTTNNBBHTNNNT
BTTNNNTTNNHNTTHNNTNNTNNHBNNHBBHNHHNTHTTNHNHHNNTNNBHBTHBTNBHBBBNNNTNNTNNHNTTTHNNNTNNNNTNNTNNBTNNTNNNN
BNTNNNHHBTNNNNTNTNNNNTTNBNNNHNTTNNTTNNNNNHHBTNNBHBNTBTNHHNNNBNHNTNHNHNHNTNTBNTNNHNNNNNTHNTNNNNTNNNTT
NNHNNNNNNNHHNNNTNBTHTNNNNBNHHNTNNNNTNNNTNTNHHHNHNNNBHNNTNNTBTTNHTNNHTTNNHNNNBNTTNNTNHHHNNHNHBTTHNNNN
NBHTNNNNNNBNTNTHHNTNNNBNNHNHHTNTNNNHNNNNHBHTNNNBNNBBHTNBHTTHNHNBHNNBNNTNHNHNHHHNNNHTHNBHTNNHNHBNTNHN
TNHNHHNNTHNNBNNBHHNTBTNNHNNHNTNHBNNHNHTHHNNNNNTBBNNTTNNTHHNTTNHNBBBNBNBNNHTHHNNNTBNNNNBNHNNBNBNTNBNH
NBHNNNNHHBHNBNNBNHNTHNTNNNNNNTBHTNNHHTBNTNHBHHNNNNNNHHNNNTTNHTNHTNTHNHTNNTNBTHHTTNNNHTNTNTHHNHHBNHNT
TNTTTNNTHTNNHNBNNTHNTHNHTNNNNTHHHNNNNTNHBBNNTTNTBTHHNNBNTNHNBNNBHTHTBNNTHNNNNNNBNBBTBNTNNTNNHHNNNHTH
NNHTHNBHNTNNHHBNHTBHHNTNTNNTNHNNTBNHNNTTBNHNNNTBBHBNNNBHBNNBBHHNNNTNNNNTHHNTHNTNNTTTNHNHNNTNNNNNHHBN
HBTNNNBNNHHNHNBNNTNNHNTTNNNNBHHNHNTNHNNNTNHHHBTTNTHBNNNHBNNHHHHTTNNNTNTNNTNNTNTNNTNHHTHNNTTTNHBHNBTT
NNNTNNHTHNTHNBNTHNHTBTNNNHNTBNNHNNTNBNHTNHBHNBBNNNHBBBHNHHBNHTNHNNBNHNTNNTBHHTTHNTTTNTNNNTNNHNNNNTHT
NNNTNBHTNNTTNNNTBHHHHTTBHNTTHTHNBBNTNHNNNTNNNNNTBHNNHTTBNNNTHNBNBNNNNHNNTHTNNNNNTHNNHNNHTTNTTNTNNNHN
THBNTNTTTBTHNBNTTNHNNNNTBTNHHHTNTBBNBTHTHNNNBHNHBHNNHHHNHNNNHNTHTTNNNNBTHBHHHTHNNNBTNNTNNBNTHNTNHNHH
THBNBHNTTHTNTNTNHTNBNNTBNHNNHTNNNHNTHNNTNNNTHTHNTHTHNTTNTTTNNHHBNTTHTBTNNTNNTTHTBHTNTNHTNHHNHTBNHNNH
NNHNNBTNNNTHNNBTNTNNNNTNHNHHTNNNNHTNNNNTHNNTNHNNHNBTNHNBNTHHNHNTTTTHNTBNNHTNNTHTNNTTNHNNNHNHHNBNTNNN
NHTHNHHNTHBNBNTNBNNNNNTNBNNBNNNNNBHBNNTNBTHHHHNNTTNNTNBNNNTNHHNNHNTNTNHHNNNHHNNNHNNBNNTHHHNHTNTNNBTN
BBNNNNNHNNTNTNHTNNHNNNHNHNNNNTNBNHNBNNTTHNBHTNHNHHTHHBNNNHNNNNBHNNNNHTNNHBBNBTHHNNHNHBHNTBBNNTTTTNTN
NNNNHHTHHBNNHNNHTNNHNNNBNHHTNNHNNNTNNHHHNHNNHNNHTHNNNHNNTNNTNNHNNHNHHNNNBHNBNTNTBNNTNTNBNTHNTBNHNBNH
NNNTHNNNNTBNNNHNBTNNNNNNNTNNNNNNNNBBHNNHNHNBTNTNNNHNHNNTNNNHNNTNNNNNHHHHNNHNNNNBNBTNTBTTHNTBNBNNHNHT
HTNTHTHBBNNNHTTBTHNNTNHHNTNTTNHHTNNNBHNNNNNNNNTHHNHBTHNNTNNNNHNNNNNHNNNNNNNNNNNHHNNNHNNNNNHNHHNTNTTT
NHTNNNHHHTNHHNHNNNNNNNNNBTHNTNNNNTTNNNBNNNTHNNHBTTHNNNNNTNNBNNHTNNHNNTHTTBNNBNHHNBHNNBNHNNNBNNHNNNNN
HTBTNNNNTTNNBBNNTNBHBHHNTNTNTTHNNHNNNHTNHTTTNTTNHNHTNHBHBNNBTTHTNHHTNNNHNNTHHNHTTHTNBNNTNBNHNTTTNNNH
BNTNHNBNNTTNNTNNHNNBNNHHNNBNNHHNHBBNBNTNNNNNNHTHNNHNTHHHHTTNNNNBHNHNNBTHHNNTHBNNNHTHNHNTNTBHNNHTHNHN
NBTHHTBNTNHNTNTHTNNHNNBNHNNHNTBTNNBTNBNNHHNHHBNNBTHTTTNHTBNNTNTHNTTTTTNNNTHNNHHNHNNNNHHNNTBHNTBHTNTN
BHNTTBNTHNHNHNNNTTNTNBTNHNBTHHBHNNTBBNTTBBNBNNNNNTNHBBNNTBTHTNTNHTNBHNNBNNHBBHNTHNNTBHNTNNNNNBBNHNHT
NNTHNTNTNNBHNNTTTTNBNNTNTHNNHTNHTNBTNBTHHHNBBNTTBNNNBNTTNNNBHHNNTNHHNHHNHTNTTTNNNNNTHNHNBNNNNTNTNNHN
HTNNNBNNNNNBTHTTTTTTNBNHNNNHNTNNTBNTHNNNTHNBHNNNTHNNTHHBNNNHNHNTNNBHNHHHNTNHBTNHNNNNHNBTBTNHTNNTNNNT
NNNNNNNHHNTNTNNNNNNHNTBTTHBNBTHTNNNHTBNTNNNNNNHBTNNTBHTTHNTNNNBBHNNHTNNNNNTNTNTNNTBTBNNTNTBNNNTNTHNN
TNNNTHNNNNNNHNBTTTNHHTNTTTTNHNHHTTNHNTNTHNTBHNNTBNBNBTNNTNNNNNNTNNNNHHBNNHBHNTNTTHNNNHNTTBHNNNNNBHBB
NNTNBNNNNNHHNNHNTHNTHNHNNHNTNHNTNTNTHNNNNNNNHHHNNTHHHHNTNHNNTTHNHNNNTNTNNBNNTNNNNNNNTNTTTNHHNNNNBNNH
BNNTTHNHNTNHTBNNHNNNHNHNHTTNNNBNTNBNNNNNTNNNHTNNNNHHNNNHBNNNNNNNBNNHHBHHNHNNHNHNTNNTNNHNTNBNNHNTTTHN
NNNNTBNTHNNTTNBTNNHNBTNTNBBNHBNTNHHNTHNTTBTNNNBHNNTNNNNBTTHBTNNNTHNNBNNNNNTNNNNNTHHNNHHTNHHBNBNNTNHN
HHBNTNBNHTNBHNHTNTTNBNHNTNHNNTHHNHNBNHHBHBHNNNNNBBHNNHNNHNNTNNTBNNNNTBNNTNNNNNHNTNHTNNNNTNNNNTHHNNBH
HTNTTHNTBTNTNNHBBHHNHTTTHHNHBTTTNTHNNNHTNNNHNTNNHHHTNNTTNNBBNBNNHNNHHBBNTHNHNNNNTTHNNNTNNHNHTHNNBNHT
NHNTNNNNNNTBHNNNNNTNNHTNNNNNNNBNHNTTTNTTNHBBNNTNBNNTTNTNNNNNBTNTNTNTNNTTNTNNHNNTNTNNTHNNNNTNNBNNHNTN
HNBNTNTNBNBHBTNTHTNNHNTHHTTTHHHTHNTHNNTNNHTNBBNTNNNNTTBTNNNBTNNNNHTNTTBHNTNBBNTTNTTTTNHNNHNBTNTHNNNN
HNNTHHNTNTNNNHNHBNTNNTHBNNNBNTBNNNNNNNNTNNNNHNNNNNBNTTNNNHNTNHHNHNNNHNHNNNNBNTTHHBNNNHNNNHNTNNNNTTTT
NBNHNHNNNBNTNBNNNNNHTHHTNTHTNNHNHNNNTTNHNNTBHBNNHTNTNNNNNTBNBNBTNNNHNNNTTNNTNTHNNNBNNNNNTNNTNBHTNTNN
NHNHHTHHTTTHNNTBTBNTTTNTNNTNHHHNBNTNNTNNNTNTNTNNNTNHNNNNNNNTNHNTNNNNNNBNNNNNNTHTHNHNHHHNNTNHNNNHTNNN
BHHNNTHTHBBBTNHBNHTBNNNNHNHBNNNTNHNNNNNNNNNBNTNNBNBBTNHNNNNNTHTHNNHBHNNNNNNBTHTNHNNNHNTNBHTNHTTNHBBN
NTHBBBNTNNNTNNTNHNTNNNNHHNNNNNNBBNNHNNNTNNHTNTNHBHNNNHBNNNNTNHNBHNNNTHHBNTTBTNTNNNHHHBNHTNHBNNTHNNNH
NNNTNHTTNNNNBNTHNNHHHNNHNNNNNNTTNTBNBNTHBNTTNBNTTNNNNNNHTHTNNNNHBTNHHNNNHHBNNHHNNNTTHNBHNNNNHBHBNNTN
NTNNHTTTTNHNNNHNNNTNNBNNNTNNTHNTNNHHNNNNTTNBTNNTNBNNNHBHHBTNTTNBTNHBTHNHBNNNBNHHTNNHHHBBNNBHBNNNNHTH
NNNTHHHNNTNTTNTHNTNTHNHNNNNNTHHNHNTNHNNNHHHNNHTNNHNBBNNNNNTHTNNBNNNBHTHTTTNNTNTNNNTTNNNTTNTNHNHNNTTN
HNNNBHHNBNHTNBNNTNNTNTBNNNTBBNNTNTNNTBNTNNHNNNTHHNHTNNTTHTNHNNTNNNTHTNTHHNNTBHHTNTHHHTNHBNBNNNNTHNNB
NNTNNBHBNTNBHNTNTNTNNNNNHNNTHNTBTHHNHNNNHNNTNTNNHHNTTTHNTNHBTNNNHNNTNNNHTHTNNTNNHHNNNBNHHTTNTTNNBNNN
NNHNBNTNHHNNHNBHNNBHBTNNTTNTTHTHHNNNTNTTBNNHNNBBHNTNNNTNHTNTTHNTHHTNNBHHNNNHTBNHNTNNHTHNNTNHNNHNNNNH
TTNTNHNNTHTHNTNTHHTHHTNTTHNBNHHNBBNTHNTHNNNTBTBNNTHNTNNNNNBNNHNTNNNTHNTNHHNNNTHTNNHNNNNNNBNHHHNBTNNN
NHNHHNNHNTBTTNNNNNNBNTNBNHNNNHBNNBTNTNTTNNNNNNBHBNNNBNNNNNHNNBNNNTNHNHNNNTHNBTTTHNNNTNNTNNHHHNNHNNTN
TNHNHTHNHTNTNTHTNHNNNNNNTNNNNTTNHNBTBNBTHNHNTTHBBHTNNHNNBHHTNNBTHNNNNHNBBHNHTNNNNHHTNNNNTTTNTTHBNNNH
NHHBHNNBHNTNNBHTBTNNNNBHBNHNNTTTNNNNHNNHNTHHNTNTBNTNHNBNBTBNNHTTNNHNHBNNNHTHNHTNNHNNNNNNNHNTTNNTBNNB
TTTTNHNNTHBTNHTNHTBNHNNNNTNNTHNNNNHHNNNNHHNHBTNNNHNNHHNNHTHNNNHNHNHNTNHNNTHNNNTBHNTNNNTNHNBNNHNTNTHT
TTTNNHBNBTBNTBNTNNNHNNNBNNTTBTNNTNHNTBNNNNTNNHNNTHNHTNTBTBTBNBNBHNBNNNNHBHNTTTNTTNHNNNHBHNTBNNNNNNBN
NNNNNTHTTNNHNBBBNNBNNTTNTTNHNNTNNNNNHNNHNHNNTNNHNHHTNHNNHNNNNNTHBBTNNNHNBNHBHTHNNNNHNNNNTNBNHTBTNHNN
NTNNTBNNNBTTNNTTHBTHNNTTNTHNBBTNHHNHTTTTHNHNTBHTNNTNTNBNHHNHHHTTNHNNTHNNNHHNHNHNTTTTHNTNHNTTHTNTHNNN
HNTHBNNNNTNNBNNNNNNBNHNNNBNNNNBNHNNTHNNTNHHHTHNNNNHNTTNTNTBNNNNTNNHNHBTNBBHTHNTNHNBNNNNNNNBNHHNTBBHN
THHHNNBNNTBNNTTTHHNTNTHNHBNHHNHNTHTTTNNHHNTHHBNTNHHNHHBBNTTBTTNNNBNNNHTNNNNNHTNNTHBNHNHBNNBNHBHNNHTB
NTNTNBTHTTNTNNNHHBTNNTHTNBTTNNNNNNTHHNBHNHTHNNTTNNBNNBTNHNHHNNBNTBTNNHNBBTHTNTNNNTNHTNNNTNNHNBNTHNHT
HBNNNTNNNNBNHTHNHNNNNHNNHNNBTTNNHHNHHHBTNBBHTBHHNNHNBNHNNNTBNNNTTNNNHNHNNNNNBNNNNHBNHBNNNNNNNBHNBTHT
NNBTBNBTHNHHBNNNNNHTNHBTNNTTTHNNHBNNBHHTTHTTNNHTBHBNNNNTTTHHBNNNNNTNNHBTHNBTNNNHNNNBHTNTNTNNHHNBBNNN
NTTTNNNTNNNTHNNBTTHNNNHHNNHBNNNHNNNNHTHTNHNTTNTBTBNNNHNNNBNTNNNNNTNNNHHNHNHNNNHNTBNBTNTNNNNNTNBNNTNN
HNNHNHNNNNNNNTHNTHNNTNTBBNNTNTTBHNNHTNTNNNNNHNHNTNTNNHNTNHTNNNNNTTBHNNTTHNNNHNTNNTNTHTTHNTTNNNBNNNTN
BNTNTNNNNNNNTNTNHHNHTNNHNNTTHBNBTHHNNNNNNNNTNNHNNBBNNHNNNNHHNBNNTBNTBNHNNNNNHTHNNTNNHHNNHNNTNTHNTNNH
NHHHNNNTNNTTHNBNNTNNNTBNTTBBTHHNTNHNHNHNBTNNNHBTTNTTHBBHNHTNTHNNNTHNTTNHNNNHBNNNNNTNNHHBHNNBHNNTNNNN
NTNNNNNNBNNTTTNNNNTNBHNBNNNTHBTTNHHTHBHHNNHNNNHBHNHNTTTHTHNBTHNHNNHNNHHNTHHHNNHTNHNNNNHHNHTNBTNHNNBT
HNNNHNNNTNNHNHNNHTTNNHNNNNNNNTNHNNNNHNHNNTTNHTHBTNNHTBHTBNHNBHNNNNNNHHBHNNHTTHNHHNHTBNHNNHNNHHHHBNBN
HBNNTNNNTNBNHNNHBBNHHNTNTTBTHNNNHNBTHNTNNTNNTNNNBNHNNHNNNHNNNTNNTTNTNNTNNNNBHTNNTNHTNHNTNNNNHTTNHHNN
HTHBBHNBTNNHNHNNNBNNNTHBTTHHNNTTHNNNBNHNNNTBNNNNNTBTTHBNBNHHBNNNHNNBNNBNNNHNHHNNNBHHBNTNNNNNNNHTNNNB
THNHNNBNHNNNNHHHTNNNNNNNNNNNBHTHNNNNNNHNNNBHNTNNNHTNTTHNTTNNTTNNNBBNTTNNNNNNHHNNNNNTHNNHBNBNNNNNNTHN
THHHNNTNNHTHTNBBNNTNNNNHNNNBTBHTNTNNTNHNBNNHNNNNTTNHNNNHHNNHNTTNNHNNNNNHNNBNNHHNBTNNNNNHHNHHNBNNTNHN
NHHTTHNHNNNBTTNNNTNNNNHBNHHTHTTHTNNNBNHNNNTTNNHNTTNNTTTBNNHTNHNNNHNNNBNNTNTTNBHNNNTHTBTTTHHTTBHHHTNH
NHNNBHNNBNNBBNTNHHHTBNTHTNHNNTHHBHNTBNBHNTNNBHNBNNTBNHTHHNBTNTBHNTTBNBNHNTNNHNBNHHTTTHNNNNHNHNNHHTNT
HHNBNHTNTHNTNNHTTHNTHNHHNNNNBNTTNNHNNTNNHNNHHHNNNHNNTTTTNNHTNNBBNNTNBNTHHNNNTNTHNNNBNHNNNNTNTHTTNHBN
NBNNTNTTNNNBHNNHNNNNNBNHNNNHNBNNNBTNNNNNNNBTNNHNTHNHTNBNNNNHNTHBNHNTHTNNNTNTNTTHBNNTTTHNNHTHNBTHNTNH
HTTNHNBHNTNHNBNBNTNTHTNTHNNNTNTBHNNBNNNNNTBNTBNNHTNNNNBNNNNNNNHNNTTNTTNNTNNNTNTTNHNHNNTNNBHHNTNNNTTH
NBBNNNHNHNTHHNNTNHHBNTNTNTBNNNNNTNNHHNHHHNNNBNTBNNNTNNNNNTNNNHBHNNNHHNNHNHNHTNNHNNBNTTNNBTNHHNNTNNTT
NNNTTNBNTHNNHTNNTNHNTTTTNNTNNTNNTNTBTHNHHNNHNNNTHTTBNNNHBNNBNHHTHNNHTNNNNNNHTBNNNNNNNTNTNTBTHHTNBTNH
BTNNNHNTNNNNBBNNNNBNNNNNNNTNHNTNNHNHBNNTHBHNNNTHNBTNBNBTNHNNTTTTBTTTTBTNTNNNTBNHNNNNBNNHHNTTBTHBHNNT
NNBNTBNNNNTBHNBNNHHBNNBTNTTBNHNNTBNNNTNNNNNTNHNNNTTNTBNNBNHNNNBHNNBNNTNHHHTNNNHNNHNHNNNNTBHTNHTHTHNN
