(52, 11)
TNNTBTHNHBTNNHTHNTTNTBNNHHTNNNHNNNTNTNNNTBTTNNTHNTBNNNBHNNNNNBBTNTNNNTBTNHTNTNTNHTNTBTNBHNBHNNBTHNBH
NNNNHBNNNNTHHNHHHTNTHHNNHBTNNNTNNBTNNNTNNNTTNNNNNNHTBHTNTTHTNHNHTNNNNHHHNBNNNHHNNNBNNTTNNNNNNHBTHBNH
HBNBNNNNNNTNNNNNNNTNHNNTNNNHNNNNNTHHNHNTHNHBNNTNNTHNHTNTNHNNTBBHHNHNNHNTTNTTNHHNHNNNNNBNHTHNNHTHTNTT
NBNTHBNHTNHHNNNNHHTTBNNNNTNNHNTHHNBBNNHBNNNNNNTBHTHNHHNBBNNNNTHTNNNNHHHNNNNHNNNTHNTHNNNNTNNNNHNNNHHT
HTTHNNNTNBNNTHTNNNHHHTTNNTHNHNNNTNHTHNNTHNNHTNNNTHHNNNBHNHHHNNNNNNNNTNHNTHHBNNNHNNNNNNNTNNNNHNNNTNBN
TNNHTNNNHTNTTNNNBHNNTNNNNNNHBTNNNHBHBHTBTTNNNTHTTNHHBNNNTTHNNBNTHNNNNBNTHNTHNNHTNHNHHHTNBTTNNNNNNNNN
NHNHBNNNHTTTHTNHHTNTNHBBNHTNHNNHTTHHNHHBNHHNTTNTNNBTHHHNNTTTNBNNNHNBNNNNNBTNNNNTTNHHBBBNNTBNNHNNBNNN
TTNTHNNHHNBBNBNBNNHBNNNTBTNTNTNHTHNNNNTHNNNTNNHHBHTHTHTTTTTNHNNTNNTNNTNNNNHNNNTNTTTHNBBHHNTNTNHTNTNN
NBNBNTNNNNTHNTNNNHNTTHBNTNTHBHNHBBNNNNTTTNHNNBHBTTNNTTNBNHNNBNNNHNNNTNNTNNNHNHHNNNHNNNBNNNNNNNBNNHBN
NBNNBNTNNBTNNNNBTBNNNHNHNNNNTHNHNTNNHBHTTNBNNNNHHHNNNNHHHNBHNNNTNNNNNHNTNNTNTNNNNNNNNNHTNNNNNNTNNHHN
NHTHNBNHTTBNNNTNNHNBHHNBHTNHHTNNNHNHTNHTTTNHTTTNHNHHNTNBHNNTNTNNNNNTNNHNBNNNHHNHNNNNBNTNHTNTBTTHNNNH
HNNTBTTNNNHNTBNTNNNNBTHNNNHTNNHNNTHNNNNNTNNNHNNHBBTHNBNNNBNNNBNBNNTTNBNTHNNHTNNNNTNHHNHTTNBHNBBNNNNH
NHNHNNBBHTNTNHTNHNNHBTNHNHNBNNTNNBNBTTNTNNTTNBHTHHNNHNTNNNNNTHBNNTTNBTTHNNTTTHNHNNNNHNNHNNNNNHTNTNNN
TTHBNHHHNNBTNNHNNNNTNBNHNNTTNTTHNHNNNTNNHNNTNNNTHNBBHNNNTBNBTNTNTNHTNNNTNNTHNNNTHNNNNHNHNNNNNTHNHBHN
NNHBTNHNBHNHNTHNNHTTNNHNNNTTNNNNNNHNNTTTNHTNNBHNNTNNNNNBNNNNHNBTNHNNHHTNNNTHNNNNNHNNTHBNTTNNNNTTNNNN
NBNNBNHHTNNTNNNBNHBNTNNNBNNNNHBNNBNNTTNNNNTBNHNNNTHTHBHNNTNTNTHNNNTTNTNNNNNNBNNNNHNNNHNNNNTNNNHBNHBN
HNHBHNBNBTNBNHNNHNNNTTNNNTHHNTNNNTHHBHNNNHBTTHHHBTNNTNTNNBNNNNHNTTHBNTNHTTHNBNNNTTNTNBTNNNNTBNHNHHTT
NNBHTBNTNHHNHNTNHNNTNTTTNBNHTBBNNHNNHHNNNNNTNNNNNNTTNNTNBNHNNNNHHTNHTNHNNHHTNTTNNNHHBTNTTHTHNNNTNHHH
NTHTTHNTHNTNBNNNNNHNNNTNNNNNNNHHNTNHTHNNTTBHHHHNNHBNNNNNBHNNTTBNNNNNNNNTNNNTHTHNTNNNTHNNTNNNHHHNNNTB
TNNBNNTBNNBNNNTHHTNTHHNBNBNTHNHNNNNNHHNTNNHNHTNBTHNHNNTBTNTTHNNNNNNBNHNTNHNHHNTNNTTNTNTHHNTTHHNNNNNB
NNHHHHNTNTBNNTHHNNTNHNNHNHBNHTNNTNNTNHHNTHHNTNHNNTNNNTHNNNNHTTHNNNHBHBNHNBTNNHBNTTNHNNHNNHTTBNNNNNNH
TNBNHHNBTBNNNTTNBNBHNNTNNBTNHTNNHNTHNBNNHTNTTHTTNHHNHNTHTHTBTHTNHNNNHTNHHBHHNHTHNNHNNHNNTTHNBNHTHNNN
NNNNBNHTNHNNNNNTNNNHNTNBNNTTNNNNBNHHTHNNBNNNNHTNNBBHTNTNNHBNNBNHTTNHHHTNNNHBNTTNHNHTNNNNTNNHNNBNHNHB
NNHNHTHHTNTHNTNNNHTNNHTNNNNHBTNHHHNTTBNNNNNTTBBHNTNTHTHHTBNNTNTTTTNNNTHNNNNNNNNHNTNTHNHHHNTNNTNNNNTH
BTNNHNNNTNTHNNNTNBBNNTTNNHTBTTTHNHTNHTNNHBNHBNHTHNBNTTNTHNNNNHNNNBNTNTNTTNNTNNNNNBTNNNTNNBTHHBBNNNNN
BHNBBHHNHNTTTBNHNNTNNBNNBNNNTHNNNTNTHHNHHNHNHHNNBHNHNHNNNHTHNNNTTNNHTHNNTHNHHNTNBNHBNTNNTTTHHNHNNNHH
NNNHHBTHNNTTTNTNNNNBBTHNHNNNHNNNHHNNNTNTTHTNTHNNTNBNBBNNHHTHNNHTNHNNNHTNNNTBHHHHNNTNNNHNBHNNNNNNHHNB
NTNHNHBTTNBBTNNHTNNBBTNNNNBTNTNHNNNNNBNTBBHNHNNNNTNTNNNBNNHTNBBTNNHTNNHNHTTHTNNBTBHBNNNTTTNTHNNNBHHN
NTHNTNNNTNNNHNNHHNNHNHNHBTTTTTHHHNNNHNHTNBNHHNNNNHBTNNHNNNNNTNNNHNHHNNHTTNBNNNTNNNNTTHHHNNNTTNTNNNHN
BHHNTNNNNNTNHTTNHNNTNNHHTTHNNHTNHNBNBTTHHNTNTTNNHTNTBTBNNNNHBBTHNHTNTHBHNNNNBNTHNTNHHNTTNHBNHHTHNNNN
NNBBTHTHTBTNBBNBNHNNHNBBNNNNNNHHNHHNBTBBNNNNNBTNNBNBTNNTNNNNBHHNNNTNTTHHNHHTNNTHNTTNNNNNNHHNNNNNNNNN
THTHNTHBNNNBBBBTNTNNNHBTNNNTBBTHHNTHNTNNHHHHBHBNTNBTNBTNHTBBNTTNBNHBNBNNBHTBTHNHHNHTTBTTNTNTNBBHNNBH
BNBTNTTNHTNNHNNBHHNNNTHHNHNTTBNTNNBNTHNNNHHNNBHTHNHHTNTHTBHTNBHTTNNTTHBNNTNNBBNNHNNTHNNHNNNBNNHNHTNB
HNNNTBHNTTHBTHNNTNTNNNHNTHNBNNHBNNNBNBTNBBHNNTBHNNNNNNNTHHNNNNHHNHNNNTTHNNNTNNBHNTHTHNHHHNNBBNNNNTNH
NHNHHNBNNNTNNBNBNNHBBNNNNTTHHNNBNNBTHHHTTNNTTNHTNNBBNNNNNTNBNNTTNTTTNHHBNNHTNNBTTHNHTNNBNNTHNNNNBNNN
NNBNNNNNBNBHHTHNNNNNTBNHNBNNNTNHNBTNBNNNNNHHBNHNNTNHNTNHBNNNBTNTHHNBNNHTNNNBHTNNBNHNNTHNNHNNBNBHHTNN
NNHBNNNTNHNNNNTTHNNNNNNNNHTNHNNHNNNNHNNNNTNTNNHTNTTHTNBNNHTNNTNTNNTHHNNNTNNHNNTNNTTNBTHHNNHHTNNTTNNH
HNHNNBNNBTBHNNTNTTNHTNBNHBHNTNTNTBNTNNNHNTNNHBHNTBNBNNHBNNBNNNNNTHTNTNBNNTNTTHHHHHHHTTNNHHNTNNTNNNNN
TNNNTNHNNHTBHTNNNTNNBNNBHHTNHNHBTHNNHNBTTNNBTNTBBNNBHNTNNNBNHTNNTNNNNNTTNBNNNHNHNTNBTTNNTNNHTNHBHNNN
NNNNNNHNNTTHNHHNNTNTNHNTTNNNNNNBBHTHHHNNNNNHNTTBTBTBHNNHNNNHTTNBNTNNHHNTNNHBHNHNNBNNNNHHBBHTTBTNBNNN
NNNHNNHNTTNNTTNTTHNNHNHNNBNTNNNBNNTNNNHHNNNTHNNNHBNNTNBBTBHTTBHNTNNNNHTBNNBNNBTTNTNTNHNBTNNNHHNTNTNN
HNNHTBBHTTTNHNTBTNNNNNNHNHNNBHNHTTHNTHNNTNNNNHNNNNTNNNBHNHHBHNNTTNTHHHNNTNNHNNBHNNNTHNNBNTHHNHNHHHTT
HTHBBHNNNBNNHNHTNNNTNBBNNNNHNNHBNNTHNNTHNNNTNHTTBNNNTNNHHNNNHNBNNNTNHBTNBNBNBTNNNNNNTNTBTTTTNNTNBNNT
HNNTNHHNNNNNNNTTBHTNHHTNNNHBNBNNTNBTNNHNTNNTNHHNNNNNHTNNNTHTTNTTNNHHTHNNNHTHNNHTNNNNNTBNNBNTNHBNTBNT
NNNNNTHTNNNNNNTNHNNNNNNNNBTNNNHNNNNNTHNNNNNBNNHNTHNHNNNBTHTNNNNNNBNHBNHNBTHNBHNTNHNHNNHTNNTNNNHNNTNH
NHHNTTNNNNTTHBHHNBBHTNHNNHHBNHNNNTNBNTTNNNTHNNNHNNHNHHNTNNNHHNHNTNNTTNBHNNNTHNNNNHNNNNHNTNNTNHHHNNNH
NNNHHTNNHTNNNNNNHHTTNNNTNHNBNTNBHTNHNTNTBNHHNNNNNNBNHBNNNHNNBNBNNNNNHHHTHHBTTHTHNBHBBHHNNNNNNNHHHNNN
TBTNNTBNNNNNBNHTNNNBNNNNHHHNNNNNTNNNTHBNNBBNNNTNNTNTHBNTHTNNHTNTNHTNBHNHNHNHNNBTNNTHNNHNHTTNBNHBTNHH
NHNNHTTHHHNNNTTTNTNNHNHNHHNHBNNTBBNNNNNTNTNNNHNNHTBNBHHNHNNNNNNBHHNNNHNHBNNTTTNNHHNTNNNNNHHTNBNNNNBH
HHBBNNTNNTNNHNTNNNNNNHNNTNNBTNNNNTTHTTTNNTBNNNNNTHTTHNNTTTBTNNNTNTHNNHNNTHTHNTHNNNBHTNHNNHHBNBTNNHBN
HBNNNNNHNNNBTHNHNHTHNNTNHBHNNNNHNBNNTHHBNHNTTNTTNNNTNNNNNHTTBBHNHNNNNNNNNTTNTNNNNNNTNTNNTNBTNTNHNNTH
HTNNHTNNNNHTHHTHHNNTBBNTBTNTTTBNTNHNHHNNNTHNNTNHHTNBNHHTNNNTNHNNNBNNTNNTHHTTBNNTTHTTNNNNNTNNHNNNNHNN
THNHNNHNNTHTTNBTNNBBNBTNNNNNNHNHTTBTTTNBBHHNBNHTTNBHNTNHNHBNNBHBNNHNTNTTNNNNNTHTNNTNBTNNNHNHHHNHNBNN
THHNNNHBHBBHTNNNNBNTNNNHNNNNNNTHNNBTNHNNTNNNHTTNHHNBBHNHBNTBNTBHTNNTNNHHNBNTNNNTTNNHTBNNHNBNNNNTNNHN
TTHNTHHNHHTHTNTNNNNTHBHNNNHTTNNNNHNTHNHNNHNBNTNHNBBNHNNNNHNNNBNTHNNHNNBHNNNBNNTHBNNHTNHNNNTNHHNHHNTT
TNNBNTNHBHBHNTNNTTTNNNBHNTNTNHTBBHBHNNNHNBNNBNNNTTNNBNHNHTNNTNHTHTTNTHTTHNNTHTHBNNTNTHNNTHNNTNNNNNNT
NHTNTTNBTBHTHHNBHNNTHNHTTBHTHNTNNNNNHNNTNTNNNNNNBNBNNNNNNHHTHNTNHNNHNHBNHTTNNNBNNNTBHTNTTNHNNNHNBHNB
TTNTNNNBBTBNNBTNHNTTNNBTBTBHNNNNHNNHNTNNTNTHNNNNHBTNHNTHHNNNTNTTHHTTNNNHNNNBHNTNNNHTNTNNNNHNBNNNNNNN
NTTNNBBNTBHNNNBBHNNNNTTHBNNTNNNNNBNNTHTNNBTTHTNHTTBNTBTNBNHTBTNNNNBNNHNHNNHTHNNTNHNTHNNNHHNNHNHBBNNB
NTHNNHHBTNTNNTNHNNTNNHHHNTBNHHBTNHNHNHBHTNNTNNNNTNNNTNHBNNNNNTTHNNNHHHBNHBNBNBNTNNHHNBNHTHNNNTHNNTNT
NBNNNTHNNHNHTBNNNHTHNNHHNHNNHNNTNTTNNNNHHBNNHBNHNNBTNNHNTNNTTHTNNBNNNBTBNNHNTNNBNNNNHTTNNNNNBTTNBHBH
TNNNHNNBNNNTTBTBHNHHNNTHTTTNHNNTNTTNNNNNTNNHTNTHNNBNNNNNHTNNNTHNNNHTHNNTHNNNNNBNNTHTNBTNNNNNNNBNHTHN
THNNHNNNTHNTNNNBTNNHBNNTHNNNTTNHBBNNTNBBHNBNNHNNNTNTNNTHTNHNHBNNHHTNTTTTTTBNNBNNNNNNHNNTNHNHHBHHTHTN
NNNTNNTNNTTTBHHTTNHTNTNTHTHBTNBNHNHNHNNHTHNHNNNNTTNNTHTNTTNNNNNBNNHBBHHBNNNHNNNHBNNBTTTNHHBNHNTTTHNB
HTNHTNNNTHTBBNNNHNNTHNHHNNHTNNHNTBHNNNTTNNNBNNNHNNNHNBTHBNHNNHTNNBNNTTNHHNNNBHHNHBNNNTTBNNTNNHNTNNNN
TNHTNNTNTNBTNNTHNNNTNNNNNNTNNTHNTNNBHTHNNTHTHNBHNNTBNNHBNNBTHNBNTNNNNNNHNHHTNHNNTTTBTNHNTTNNHNTHNNTT
NTNHHHNTNTNNNNHNTNNHHNTNHNTTNHNNNHNNHNNHNNTHNNNNBNNHHTTTHBHBTNTNNNBNNNNNNNNNNTNTBTHNNTHNNNNBNBNNNHNN
NHNNBHHNNTNHBNHHTNTNNHNNTBTHTNBNTNNHNBNTTHHHHBNTNNNHNTNNNNTTNHNNNTHBTTNNNNNTHHTNNBNTNHHNHNNNNTBNTBNN
NNNTNNTNNBHTNNNHNTTNNNNBHTNTHBHNNHNNTHTNTNNHTNTNNHBHHNBHNHNBTNNNBNHNHNNTNHNHNHNNHBNBNTTNNNTNTNNHTBNH
THTHNNNHHTHHTHHNNNNNHNTNNBTTNTNNHNNTTNTHHTTTHHTTNBNHBBTTTHNNNNHBNNNHNNNNTNNNNTHTNNNNNNNTTNBHNNNNHHNN
TNNTNNBTNNNNTNNNNHNNTNBTTNTHNTNNNNNNBNNNTNHBNHNHNHHTTBNNHNNNBNTHHNNBBTTBNHTNBBTTNHBNTTTNNBTNTHNHTNTN
BNBHNTNNBHBNNNHHTNTHHHNNBTTNNNTNHTNNHNBBNHNNTHNTTNTNNNHNTNBTHNTNNNHHNNHNHNBTHNTTTNNHTNTNBHNNNTTNNTNN
NBHNTTNNNNNNNNNNNNNHNTNHHHTTTNNNTBNHNNNHTTTTBNTNHTNNHHHHNNNNTTNTNNNBNNBNHBBBNNHNHTNHNNHTHNBTNNHHNNHH
NNTNHNNNNHNTNNTBHNNNNNHNBTNNTNNNNHHNTHNTNNNBHBNTHHHHTTNTTHTHNNNNNNNNNHHBTNBNTNTHHNBNNNTHNBHHTHNNNHHN
NNNNHNHNNNTTTNBHHNHNNNNHHHBTNNHNTBHNNNNBNNTNNNHNNNNNTHTTHNNTTTHTTNTNNNBNNHNNNHNBTNBNNHNNNNHHHHHTBBHT
NNTBHTTNNBNBNBNNNNTNTNTNHHHHBTNNTNTBHNHNBNHNNNNNBNNTTNNNNTTNHNBNNBNBNTNHNBHTNNBNTNTNNHTTNBNNNHTNHNNH
NTNNNNTNHHNTNNHNHBNNTBHHNNBNNNTHTTTNTHHTTTTTTHNTHNTTTNNHNNHTNNNHNNBTTNNNTHNNNNNNTTHNHTBTBHNBNNTNNNNH
NHTNTNTBTTNTNNNNNNHTBNNNNNHNTTNNHNNHTHNTNNTHTNNNNHNTNNHNNHBNNNBBNNNNNHHNNNNBHNHNHNNHHNBNHBNNHNTNNNHN
NTNHBNBBNNNBNNNBNTNHTTNNNNNNTNNBNTBNTNHHBNBHHHTNNNNBTNTNNTNBNTTNNNTNNNTNTNNTBHTNBHNNTHTHBNTNNHNHHTNB
NNNHNTTBTNNNHTNTBNBBNNHNTNNNNNTNHNNTTTNTTNTNTNHBNNBTNTTNHBBBNNHHBHHNNNHBTBHNNTNNNTNNNHNTHNNNNNHHTHNB
BTTNTTNTNNNNHNHNNHHBNNNNNTNTNTHNNNHBNNTTNBTNTNNNNNHNNNHNNNNNBHNHHNTHNTNTNTHHNNNBHHTNNNNTHHNTTNNNNNBN
TBNNTHHNNNNTNNNNNNNHNTNNNHTNTBHTNBNNNNTTNNHTHHTTNHTNHNNNTHNTNHNHNTBHNHNNHNHHNTBNTNNNBNTHNNTNHNHBHBNH
BNNTTTTBTHNTTNNNNTNNNHNNTNTNBNNTHNTNTHNNBNNNNBNNHNNNNTNNNNTTTNHTTNBHHTNNTNNNBHTHNNNNNNTNBBBTTNNNNTNT
BTHTTTTNNTBNTTNNTNTHNNHHNHBNNBNNHNTHTNHNNBNNTHNTTNNNNTHHNTNNNBHHBNTNNTTNNNHHTNNHNHNTTBHTTHHTTNHNNNNH
NBBHBNNBNNTTBNBNHNNTBTTHHTBNNHTHNNNNBHNNTHHNHHTNTNHTHNBBNHNNNNNHNNNTNHHHNHBNHTNHNHNBNTNNNNTTHNNNNHTH
NTNNNHNTNBHHNNNTNNHBTTTHNNTHHNNNHNBTHTTHTNTHNNNHHNTNHTNTHHHNHTNHNNHNTBNNTBHHNTNNNNHHHNNTNHNNNTNNNTNN
NNNTHHNNNTHHTNNNNTNBHTBHNHHTNTTHTNNNHNHHNNNNTNNNNNNTTTNBNNNHNTBNNTNTNNTHBNHNNBTHNNHNNNTTNNBNNNNHBTHB
HNNBTNNNTHNNHBNTTNNNHBTNHHNNTNNBTNTHNNTNNTTNHNNNBNNNNNNHNHNBBHNNHHNBNNBBNHHNNHNTBNNHTNBHNNNNNTTHBNHH
NHNNNTNHNNBBTNNNBNTTBNHNHNNNNBNNNHTNNNNHBNNHTNNNNTNNHNTTNBNTTNHNHNBNNTNNNTNTTTNNHTHNNNNNNNNNHHNNNBHH
HNHHHNHTNHNHTNNHNNTNBNTBNNNBHTTNNTNNNHHNNTNBTNHNTNTTNHBNNNTTBTNTBHTNNTNHHNNBNHHHNTNNNTBNHHHNNBNNBNNH
NNBNNNHTTNNNNNTNNBTHNNHNNNNTNNNNNTBNNBTHTBTHNHNBNBNTTHHNNNNHTNTHNNNNNNTNNNHNHTHHHNTBNNNTHBNBNTBNHNBN
NNHNNNBNNNBHHNNNNTHNHNNNNNHNNNNNTTBHNNBNTNBHNNTHTTTNNTHBHNNNTHHTNNTTNTHNNTNNTNTTNNNTTNNHNHNNNBNNHTNN
TTTNHNTNTNHNBTHHNNBNTNTBHBHNTNNNNNTBBNNTNBNNTTTNTNNNHNHTTNTNBNHBHNNTNNBHNNHTNNNNNNNNNNBTNHBHHNNNNHHB
NNNNHTNNNHNTTNTNNTNTHTBNBTHNTTNNNTTTNNBTTNNHTTHNNNTNTTTTHNNNNHNTNNTTNHNHBHNHNNHNNNNTHHNNBTNNNNBHBNNN
NTTBNNHHNHHTHNNTNBNHNNNNBHTHHBBNNHHNNBHBNNTTHTNTNNNNNHNBNHNTBNBNNNNNNHNHNHHTNTBNBNHNTNTNNTNHNHTNTHNT
HNNNNHNTNHNNNTTBNTNNTNNHNNBNNTTNNHTNTTNHNBTNNTNTNTBNTTNNNNNNBNHHTTNHNNTHHNNTNHNHNNNNBTNHHNNTHNHTNNBN
NNNTNNNTNNTBNTHNHHNHNHNHBNNHNNNBHHBNTHNHBNHTNNTBNHNTHNBNNBBNNNNNHBHBHHBBBTNNTNNHNNTHNNTNHBHNBNHNTHNH
NNHHTHHNNTNNNNBNBNBTNNNTNTNNNHNNNNNTHHNNNBBHNHTNTNHBHNNTHTNHNNNNTNNNHBNTTNNNHHTNNHNNNTNHNTNNHTHHNNHB
NNNHNTNTBHNTNBTTHBTNHHHNHNTNNHTNNHNNBNHBHNNBNNNHNBTHNHNNTNTNNHBNHNBHNHNHHNHNNTHNHTNNHHHHNNHTNNNNTNNH
BTHHNNNNNNTHBNHHTNBNNNHBNBHBTNHHNNNNNBHNHNNTNHNHHNTNNTNNNNHNTNTTNTHTHNTTHNNTNNNTNNTHNNNNNTNHNNNTTNNT
