(0, 67)
NNHNTNNNHHTNHTNNNTHTTTTNTNTHHNTNTNHBBBNNNNNHBNNBHNNHHHTNTNNNNTTNBHHTNNNHTNBNNTTHHHNBNNTNNNNHBHHNNBHT
NTNNTTNNNTHTNTNBHNNNTNNTNBNTHHHNNNHNHHHHHNNNNHBTNTHNNTNHBTNTTTNNBNBNBTTTNNTNBNTNHHNHNBNNNNNHHNBHNNHN
NBHHNNHNNTTNTTNNHNNNNTNTNTHNHNNNNTHHNNTTHNBBHNHNHNNNTHTHNNBTHTNNNNNNHNHHNBNBTNNTHHNNHNNNHNHNTBHTNHNB
NTNBNHNHNNNTTNNHTNHHNNBHTHHBTNNNNNNNNNNHBTNNNBHNBNNNHNTNBNNHHHNNHNNTTHNNNNHNBNNNHTNHNHHNNTTTTBNBHNTN
NHNTTHHHNBNTHBNNTNNBNNNNNNHNNNBNTNNNTNNNNNNNNNNNNHNNNNNBNHNNNNNNTNNHHNHNNHHNTNTNNTTBNNNTTTHNTTNTNHNH
THNHHNNNHNHNHHNNTNHNBHHNTTNNBTTNNNHTNNNNNBHTTNNNHTTNNTTHNNTNNNHHNNNNTTHBTNNHHNNTTBNHHTNNBNBHHNTNNNNB
TNNNHBNHNTHNBNBNNBNBNNHNNNNHBNHNHNNNHNBHTTBNNTNNTNNBBTTNHNNHHHHHNHNNHBTNNHNBNNHNNTNNHHHBTNBNNNNNNTTT
NHBHNNNHBNTNNNHNTNBNHTNTTNNHHBTTBNTNBHNNHHNNTNBNNNNBNTNNHTBNNNHNHHTNNHNNNTBTTTNBNNBBHTTTNNBNNHNTBTHN
HNNTNBBNTNHNBTTTHTHBNBTNTNTHTNNHNNHNNNHHNHBNNTNNHNNTNNBNNHNNTNTNHNHNHNNNNHHHNNNNNBNNTNHNTTNNHNNNNNNN
TNNBNNNTBTNHNNNTNHTBNHNNHTHNTHTHTNHHNNNNTTNNBNNBHNHHTTNNNHHTHNNNNTHHNTTNTNNTNNNNHHNNNTHTTNHHNHBHNTNH
NNTNNNNHNHTHTNNNNHHNTBNHNHTNHNTNHNHHNNNNTHNHNNHNNTNNHNNTTNTNNHBHNNTNNHHTTNNNBNTNNHNTBNTNNNNTNHTNNTNH
TNNNNNNTHNNHNNNBHTNNBTBNNTNTNNTNTNNNHNTNTNNNNNNNNNTNNBNNNNTNNNNNBNHNNHNBTTHBNTTBNNBNNHNNHTNHNNHNHNHH
NNTNNHNNHHNHNTHNNBNTHHNTNHNHHHNHBHNNNHNNNTNBTNNNHNHHNHHNNNHBBTNNNTNNNBHHNNTNTNHNNNNTHTHNHNNTNNHNNBNH
NNNTNNNBNTHTNNNNNBNTTNTTNNNNHNHNTNTBNBTHBHTHNNNHHHHBBNHTNNBHNNNBBNNHNNHTTNTNNNNNNNNNTNTTHNTNTNTTNTNN
TNNTBBNNNNNHNTHHBHNHHBTHNNHHTBNNBNNHNNTHTTTHNHNNBNNNNNNHNTNTTNNHHNTHTTBNTTNNHTBHNNTBNHBBHTHNBBTBTNTN
NNNHTHTNNHNNHNHTTNTHTNTNHBNNNNNHHNNNNNHNNHNHNTNNTHHTNNBTTHNTTHNNNBNNNHNNNTHNNTTNHTTTHHHNNHNTNNHNNHTN
NHTNTNTNHTHNNNTTNBHNNTHNNHBTNNNNNNNNNNNNNNNTTHNHTTHBHTNNNNNBTTTNTBHNNTNNHNBNTHBNBHNNHTHHHHNNNHTHTNNN
HNNNBTHTHBNNTHNNBNTNNNNNBNBNNNHNNNTHNNNBBHNTBBTNHTNHTNNTNBHTTTHNHHHTHBTBNHTNBNTBBNHNNHNBNNTNNNNTTTHH
HBNHTTNTTNNTHNTHNNTNNHNHNTNNTNNHNNHNTNHNNNNNTHHNNNNNTNNNTNBNNNNNNNTNTTTNNBHTHNNTBNHNNNNHTBHNBTNHHNTN
NNBNNNTBBNNNTNNNTNTNTTTBNNNNTNNTBTHTNNHNNHNBHNNNHHNHNBNNNBNNNTNTNHTHNTNHHNNNNNNTHTNNBNNNNNTNHTNHHHHN
BHNNHTNNTHBHNBTNNTTBHNNHTNNNNBNTNHNNNTHNTTNTHNNNTNTHBNTTNTNHNNHTBNHNNNNTNHHNBNBNNNNTNNHHHNNNNTNHNNTH
NNHNHHTNTNNNBNHTTHBHHHNNNNTNNNNTTNNNHHNTNTTHNNHTTNNNHNHNHBNNHHNTTNNHNHNNTNBNNNHHNNTNTTNHNNBNNHNHNTNT
NTNNNNNTHNTTNNHTHTTBTHNNHTTTNNBHHBHNNNNNTNNNNTNTHHHHBHHBNHNNTNNTHHTNHTNTNNNBNNNBTHNNNTNNTNTNBNTNNNTN
HNBNHTNNNHNHNNTBBTHNNNNNHHHNNBTHNNBNNNHNHNNTHNTNNNNTTNBNNNBBTNTNBHBHNNNNNNNNNNNTTHNNHNBHTNNNNHNNHTNB
NBNTNHNNNHHNHHTNNTBTTTBNTNNHTBHNNHNTHNTBNTNNNHNHNHTTNNNHHNBTHTNTNNNNNHTNNNNBTNTTNNHNNNTNNTBNBNBNNNBT
HNNNNHNHNHHHHHBBHNHHHTTNNNTHNNNNBTTHNHTBNTNTNNHTNNHTBNNNNNTHNNTNNHHHNNNNTNNNBNNBBNHBBTTHNNNNNHNTTHNN
NTNTBNHNHNNTHNHBHBTHNNNTNNNNNNHNHNNNNNHTNNHBTTBNNNBNTNTTBTNNNNHNNHNNNTNNNHTHNTBNHNTBHNTTNNNBHHNTTHHH
HHNHNTHBTNHNHBBHNTTNNTNTHNNNTNNTBTNNNTBBNHNNHNTNNNHTBNNNTTNTBTTBTTNNNNHNNNNNTTHHHTNTTBHNNNBNTHNNNTHH
NHTTNTNTHNBNTNBHTHHNHTNNNTNNHTNNHNNTBHNHNHNNBNNNBNNBTNHNNNNNNNNBNNTNBHHBNTTHHNHNNHNNTBTBTNTHNHHHNNHN
THHTNNBTNNBTNTNNTNTHTNTNHTNNNHBNNBTTTBNTHNNNTBNBHBNNNNNHNNNNTTHHHTBTTNNNHTNTNNNNTNNNNNHNHTNNTBTNTHNN
HHTHTHHNTNTNNNNNNHHTNNBBTHNNNTHNHTNNBHHNTHNTHNBNTTTTNHNNNBHTHTBHHNHTTHHHTNTNNTNTTNNHTBTNTTTTNNTTHTNN
NNBHTNHNNTTNNHNNNBNNNHNNTTNHNTNTHNNHTNTNHHNNNNTTNNBNTTTNNNHNNBHHNBTTTHNNNNNHTNNNHBHNNBHTHNBBNTTNNHNH
TNNNNTNTTTNHNNBNBNNBHTNNNTNTNNBHNBHHNNTTTBNHNBTNNHBBNNNNBNNHNBNTHNHTNNHHBBNNTNTNNBTNTNNNHNNHTHTNNNHT
NNBTNNHNNNNNTHNTNNBHTBNTNNHTTTNNNTNNTNNNHHNNBNNNNNNNNTNNHTNHNNNHNNTNBHNTNNNNNNHHBNNBNNNHNHBTNHNHHNNN
NTHBNBNNBHNHNNTNNTNHBNNNNHNHNNHNNHBHNHNTNNNNNNNHNNNNBNNTHNTTNNTNBHNHTHHNTNNNNNNNBNHNNNBTHBHTTHBTBBNT
HHHHNHBTHTNNTTTNHBNHBTNNTNNTNHTHTBTNNNBNHNNNNTHNHTNTTNNNNNNNNTNNBBNBNTNNNNHNNNNNTHHNNHNTHHTNHNTTNNNN
BTNHTTNNNHNTNNNNTNHHNHNHNNTHBHNBNNBTBNTNHNNHHNNHTNNBNNTHNBBHNBTTTNNNNBNTTNHTTNNTNHNNNNHNBHNTNNTBNTTN
HBTHTNNNNHNNTNHHHNBBBNBNNNNNTHNNBTNNNNNNTNNHNHBNNHTNHNTTTHTBHNHBTBTBNNNNNNHBNNNNTNBTTNHTNNHNNNNNHNTT
NNBNNNTHNHTHHHTHTHBNNBNBNNNTHHNNNNTHHNHNBNHNTNTTHNHBHTNNTTNHNBNNBNNHBBBNBHNNBBNHNNTNNNBHNNHNBNTHTNNN
BNNHBNNNHBBNNHTNNNNHNBNHTNTNHNNNHNHTNNTTHHHNHBHNTNBNNHTTTTBHHNNTNHNNNNNHNNHNNTNNTTHHNNNTNTNNTNTBNBBH
BNNTTNNNNTHHNNTNTNTHHHTTNHNBTNNTNNNNTNTNNHNBBNNTNNHTNNNNNBBNNNNNTTBBHNNBNBNTNNHBHNHNNNHTHNNHNBHNBBNH
NNBNBTNHNTTNNNTHNTTHBNNNBHHNHNBNNNNTNHNBBTNNNHNNBTTHNTTNNTHNNNNHNNNTHNHNNBBHTNNNTNNHTBNNNTNNTTTNNNNN
NNNTTNHHNTHTNNNBNHNNHNHHHHNTHNNTNHHBHTTTNNHHNNTHNHNNNTHBNBHNTHNHNNNNNHNNNHNNNNNNHNNHNNHNHBNBNNHNNNTT
BBBBHNBHNNBBNNNNNHTHNNBHTBNNHNTTBTNNTNNNNHNHBNHNHBTNBBNNNNNNNNHTNNBNNNNNTHNNTBTTNHNHTHHNHTTHNNHNNTBT
NBNTTNNNNNNHNTHBNHNNTNNNHBNNTHNTNNNBNNTNNNNNNNNNHNHBNTNTNNNNHNTHNBNNBNHBNTNBNTNNBBNNNHNBHBTNNTTNTNBN
HNNBNNTNNNNHNHTHHHHNTTBBTHBNNHNNTTNNNTNNNHHBNNBBTTNNNBNNNNNTHNHHTHNHNHNNTTNHNNBHNTTHNNNNNHHNNNNHNBTN
NBNHNTTNNNNNHTHTTBNNBNNNNNNHHNNTNNNNNNNNTHHNTTNNTBNHHNNHBNNHTNNNTNHBNHHHNHNTBNTTNBNNNTBHBTBBNNHNNHBN
NNNHHNNBNNBBNNNNTNTNNNTHTNTNNHTNHHHHHHNHTNTHNNBHNNNNNTNBNNNTTNNTNBNNHHTTTHBTBNNNBNHTNNBHNTHNNNHTNHNN
TNHTNNNNNHNNNNHHNBHNNNTHNNTHNTNBHHNNNNNNTHNBBTNTNHTNTNHTTNBTNNTHHNNHHNNNNNHNNBNNNHNTNNHNNNNNNNTHTNHT
NHHTNNTNBHNTHNHTNHHBNNTNTNNBBNBNNNBHTTTHHNNTHNTBTNNHNTHNNNNNNNTNHNHNTNNBNBNNHHHBHNNHNTBNNNBNTTTNTNTN
NBNHNHBNHHBNNTBNHNNTHBNNBBNNHBNNNHHTNBNNNHNTBHTTHNNTHNNNNBNNNNNBNHNNTBNTBNTTNBNHHHNHNNHTBNTTHNTNNNNH
NNNHHHNHNTBNNNHBHNNNHNTNNHHTNTBNNHTNTNNNTHNTTHTNNTTBHHHNNTTNNNNNTBNBNNBBNNNTNNNTNNNNTHNNNNTNNTNNTNHH
TNNHBHNNNTTHTTTHNNNHTHHTNNNNTNBHNNHNNHNNBNTNNHBHNHHNTHNHHNHBTBNNHTHTNBHNNNNHBNBNTNTHHNNNNHNTHTTHBHTH
BNHNTNTBTNTTNHNNTNNNTNBHHHHNTHNTNNNNTTBTHBNTNHNNHTNTTNBNHHNNHNNTNHNNNTNNTNNHBTNTNTTNTNNNNNHNHHNNTNHN
TNNTBHNNNBTNNBNHHNHTTBTTNNTHNTNHTNTBNNNNNHTHBTBNHBNTNNNTBHTHNNNTNNNTHHNTNNNNTNTBNTNNNHNNNNNHHHNNHHNT
NNHBBNBTHTHTNHNTNTBBHTHHTTNTNNHBTBNNTNBHNNHHTHBTTNTHBTHHNHTNNHHHNTHHNTNTHTTNTNNNNNHNNBNNNHNNNTHNNHHN
BNNHTNNNHNNBHNNNNNHHTNNTNNNHTTNNNNNNTNBHNHTHHNHNNNHNNHNNNNTNNNNNTNNHNTNBNNHNNNNHNTNNHNTHBNBHBBTTNNTN
NHNTNNNNTNBNTTNTNNHNNNNNNBTNHBTNNNNNTNNNBNNNNTTTTHHNHNNNNNTBNHHNBNTNNBNHBNTHTNHTNTNNTNBHNHBNTHHHNNBT
NTNNTNBTHNNHNNHTHNTNNBNNNNBNBHNNBBTBTNTNNHNNNHNNTTNNHNHNHNNTNNHHBTNNNTHHHBNHHTBTTTTHHTNHNTTNTTHTHBNN
NNTTBNHNBTHNTBNNNNNNNNHNBNHNNTNNBTBBTTTNNNNNHNHNTNNBNNNTTNNNNHNNTNNNHHNNHNNTNNNBNNNNBHNNNNNNHNTNBNNB
BHTTNNNNNNNNNNNTTTNBNNNTNNHBBNHBNNNNHBHHNNTBHHTNNHBHHHNNNHHNHNNNNHNHHTNNNNNNTHNHNHHBTNHNBNNHNNHNHHHN
HNNHTHBNNNNNNNTBTHHHNTNTNHHNTNHNNNTBNHNBHNHNNNHNTBNNTTNNNHTNNNNTBNNTTTNNHNNNBBTTHNTNNHTTNHHNTHNTHNNN
TTHNNTBNNTNTHTTBNTHNNHTNNHBTTNNHNNHBNHNTHTTNNHNNBTTNTHNBBNHHNBNHNNHBNBNNHTNHNTNNHNNNNNHHBHTNBNNHHHBT
NNNNNNNTNHNBBHNNTTNBNNHNBNNNHNBNNBTNHNNBHBBBNHNTHNNTHHHHNNHTTTNHHNNTNHNNNNNNNNNNTNHTNTNNHNNNNNNNNTNN
NNHNHNNTNBNNNBBBHNNNHNHNNNNBTNNTHNHHHHNTHBNBNTNHTHHNHHTNBNNBHHHNNHHHNBTNBBHNHNNTBNTNTNNNNHHTNTNTBHNT
NNNNNBTNNBNNHHNTHNHNNHTHHBTNNNNBNHHNHHTNBNNHBTNTNNBNTHHNTNHTNNTBTNTTBNTTBTHNNNTTHTHTBNBTNNNHNHNNTHNB
NHNTHHNHNNBBHNBHNNTHTNBNNBTTNHHNNNHTNNHHTNHNNTNNTHNTTNHTNHNNNTBTNNHTNNHNHBHNNTNTNBNBHNHHNHHNHNNNTTBT
HNNTHNBNNNTTHNNNTHHNHTTNHNTNTTBHNNBNHTNNNNTNBNTTHNNNNHNNTNHTTNHNNNNTNNNNNNNNNHNNTNHNNHNHTTTNHNNNNNTB
NBNNNBTHNHBNTTHHNNHBNNNTTNNTNBNTTNHNTTTTHHNNBNHNBNTNNHBNTTTHNHBBTHNTNHHTHHNNTBNNBNHNTHTNHNNTNHTNTHTN
HTNTNNNNBHHHNTNNHNHNHHNNNNNTHNNBBNHNNNNNTHHNNNNNNNNNNNHBHNNHHNNNTTNTNNBHHNNHHNHNNNTTTHHNHBNNTHTBNNNT
NNNHHHTNTNTNNNTNNHNTBNHNTHTNNNHTNBTTNNNTHNBNTTTNNHBNTNTTTTNNNNNBHTNBBTHHNNNBBHNNNBBNNNNTTBNHNTHTNNHT
NNNHNHTNNNNBTTBNNNNBNHTTNNTNNNTNNHHNTNBNTNNNNNNNNNTHNNNBBHNNNNNBNHNNHHNTHTNTNNNNNNTTNBNTTTNHNTNNNNNN
TBNHNTNNTTNHNTNNNNTHHNNNTHTNNHBHTNNNTTNNTTNNHTNNTTNBTNNHNTNBBTNTHNBNNNNHHNHNNTNNBNNNBTTNHNNTNNTNHHBT
NBNNNNHNNHNNNHHBNHNNTBTHNBNTNHNNNNNHHNHNNNHHNTNHHNNNHNHNNNNNNHBTHTNNNTNHTTNBTTNNNTNNNTNNHNNNNHTHHTNN
NHTNTNHNNNNTHNTNNBHNTNNHTNNTTHNHHHNNHHNNHBNNHNHBTNNHTNTHHBBTNTHNTNTTNHHTHTBBTTHNNTTNHTTHNNTNTNNHTHNT
NNNNTNTTNHNNHNHNTHTNTHHTHTBNTHBHNTHHTTTNTTNNBNNNHBNTNNNTNNTNNNHNNHNNNTBNBTTNNNNNNNTNNNNNTBHTNHNHNNHT
BTNBTHNNNNHNNNHHNNHTNTNTNTTTHHHNBNTNTNBBTNNNNBNNTNNNNNBBNNBBNNHNTTHTNHTNTNNNTNHNTHNNNNNNNNNTTNNTBTNN
NTNTHNTTNNNHNNNNNBNBBTNHNTNNHTNTHNHTNNHBNNHNNBNNHNHHBNNNNNBTTTTBNHHNBBTHNBTNNNTHBTNBBTNHNTNNTHNNBHNT
NNTNNTHNTNHNNHTNNHNNNBNNHNNTNTNTNHTNNNNTNTTBTHNNNTTHNHHTHNNHHBTBNNNTNNNBTTHNBTNNNBBNBBNNNHNNTHNHTTTH
TNBHNNHNNHNNNHNNNNTBHNNBNTTBNTTNNBHNBNBNNHTTBTTNTNBNHNTTNTNHTNNHNBNHNBHHHTNBHTNNNNNBNNTNNNHBTTNNNTTT
HNTNHHNNTNTTNTNTNNNTNNNTHNHNTBNNTNNTNNNTNHHTNNNNNNNNNNNNHNHTNNNNHNBTNNTNBNNTNNBHNBNTHNNNNNBHBTNNNNNN
HNTNNTNNNNNNNNHBNTNNBBBNTTBNTTNHHNNHTBNNNNTHNNNNTHTTHHTTNHNNTHNTTNNHNNNNHNHHTTHNTTHNNNTNTNHNNNTHTNTN
TNHBTTHHNNTHNNHNNNTNNTHHNNHNNNNHTTNNNTHNNNHNNHTNTNNNTNTHNTNTHNNHNHNHTNHBTTNHHNTNNNNBNTHTNNBTNNNHHTNT
NNTHNNNBTTTHNNHTNNNNHBHHNNHNHNNNBNTHTBNNTHNNNBNHHTHNNNNNNNTBNNBTNNBNTNNTNNTNNNHBBBNHTNHNNHNTNNNTBTTN
HNHTNNHNNNNNNNHTNBNHNNBTNNNTTBNTNNHBNNNNTTNNNBNNHTHNTHNNTNBBNHBNNHNNHBNNNBNNBBTNTTNTHNNTBHNHTNNHTTBB
BNNBNTTHNNHNBNTBTNNTNNNNNTTNTHNTHBNTHNTNNTTNTNNNNNHNTNNHNBNTBHNNNTTHNTTNBNBNBNNNNNHHTNNHHHNNTHTTTTNN
HBNNTNNNNBNNNNTTNTHNHNNNTNHNNTNNBHNTNTNNTNNHNNTTTHNNTNNHTNNBNNTBNHHNTHHNNHBBNNNHHBTNNHNNNNNHHNNTTNTN
NHTNNHNTNTNHNTNHNBNNNTNNNNNNNTNNNTNNBNBNBTTTTNHNTNHNHNBNNNNHBNTNTHBHNHHNNNBNHBNTNNBNNTTHTNBNBTNNTNTN
NTHBNHTBNTHNNTNNHHHTTHHHNBBNHTBHNNTNHNHNNNNHTNNBTBHNTNTNNBBNNHBTNNNNNNNNTNHNNBNHBNNNNTBBBNTHHHTTTTNN
HNNNHHNNTNHNHHNHNTNNHNNNNNNNHTNBNNNNNNNNNNNNHTNTNNNTHNBBBNTHNNNBNTTNHNTNTNHHNTTHBTNHNTNNHNTHBHBNNNNH
HNHBBHNNHNNNNNHNBHTHNNNNTNHNHNNHHNHNNNNNTTNTNNTTNTNNNNBTTHNNTHNTTTNNTHNNNBTHHNHNNTNTNNHTNBNNNNNNHNNN
TTNHTNNNNNHNTBHTTNTHNNNNHNNNTNNNNNHHHNHNTTNHNHNNHHNNBHHNHHBNNHNNNTTHHHNNNHHTNNNNNNHHNNNHNNBTNNHNTTHN
BBNHNNTNTBNTTNNNTNNTNNHNNNTHNNTTHNHHTHNHNNNTHTHHHHNNBNBTHNNNTTHNNBTTTTNHHTNHBNNHNNNTHNNHNNTNTNBTNTTH
NHNNNNNTNBBNNNTNNNBHNNTHHNHNNBNHBNNNTNNTNTHTNNBBTNNTTTNNNNNBHHNHNTBNHNNHBTTTNNBTHNNHHHHHHNNNTNHTBTNN
NNNTNNNBHHHNNTTBHHNTNNTHBHTTTHTNNNTBNHNBBHTHHNNNHNHNNTNHBBTTNTNNNBBNNNNNTHTTNNBTBBHTNNNHNNNBHBNTNNNN
NNNNNNNBNNHNNNTNTHNNHNNBNBTNTTBHNTTHNNNNTNNNHBTBNBNNNNNTTHHNBTHHNHNTNHTHNHBTHNNNBNHNNNNTNTHTTNNNNNNT
TNNBTNNNHTTNNNNBNHTHTNNHHNTNHTTNBTNNTHNNBTBNTHTBTHHNTNNBNHTNNNNNNTNTBNNNNNNNNHNHBNHNTNHNTBNHHNNNTNHN
HNNNNTNNTNTNTNNHTHNBNHNBNNNHHNTHNNTBNNBTNNNNNNNNNBBHHNNNNNTNNNHNHNNHNNNNTHTNTTNHNNBNHNNNHNTHHNTNNHNB
NNHNNNNTTNNTHTTTNTNNTNTHNHNNHNNNNHNHNHHNHBNNBHNTHNNTNTNBNNNNTNNNNBNNNNNHNBNHTNNHNTTNNTHTNHHNHNNNNHHT
NNNNNBTNNTBNBNNTHNNNBNNBBNBNBNNTNNBNNBNNBHNBTHHTHHBBNHHNNNNNNNTNNTTHNHNTNNBBNNNNNHBHNNHHNNHNNNHHHNNN
